mv_id,polarity_mean,polarity_std,comment_count,count_positive,count_negative,positive_ratio,negative_ratio
1,-0.036101249512284994,0.5874517432513043,375,164,211,0.43733333333333335,0.5626666666666666
2,0.01419123317658857,0.4877042040499801,2019,914,1105,0.45269935611688955,0.5473006438831105
3,0.2255996569005664,0.586908204882587,1996,1214,782,0.6082164328657315,0.39178356713426854
4,0.005826141285375953,0.6991164984102501,1996,982,1014,0.49198396793587174,0.5080160320641283
5,0.03705744973838036,0.6319637502101799,203,109,94,0.5369458128078818,0.4630541871921182
6,-0.36301669902576034,0.5925785470535565,1747,409,1338,0.23411562678878076,0.7658843732112193
7,0.22364683871932947,0.6519805487071538,1996,1265,731,0.6337675350701403,0.3662324649298597
8,0.23285558937211615,0.6063197331578413,1998,1227,771,0.6141141141141141,0.3858858858858859
9,-0.23438456675027772,0.6458602444254554,1121,334,787,0.29794826048171275,0.7020517395182873
10,0.1590552359819412,0.5684990907515178,2000,1120,880,0.56,0.44
11,0.053375835103953294,0.5361870495169563,1998,936,1062,0.46846846846846846,0.5315315315315315
12,0.19897334414578086,0.5751228598492034,1998,1187,811,0.5940940940940941,0.4059059059059059
13,-0.25862898829883946,0.6135351694988075,1996,566,1430,0.2835671342685371,0.7164328657314629
14,0.22890644906840663,0.5773466628636261,1999,1280,719,0.64032016008004,0.35967983991996
15,0.16687395703855554,0.6978448338409343,2017,1185,832,0.5875061973227566,0.41249380267724345
16,0.15395497764173935,0.6115729901258373,289,168,121,0.5813148788927336,0.4186851211072664
17,0.24889918602863187,0.5574128737050223,1998,1293,705,0.6471471471471472,0.35285285285285284
18,0.012362511071084704,0.5539340799827132,1998,891,1107,0.44594594594594594,0.5540540540540541
19,0.1286702841593171,0.6768867520382792,1994,1117,877,0.5601805416248746,0.43981945837512537
20,0.11940906644815748,0.6348960901334637,1375,766,609,0.5570909090909091,0.4429090909090909
21,0.11465912878171199,0.6091866513820557,1998,1114,884,0.5575575575575575,0.44244244244244246
22,-0.07536480091521443,0.6971425856282908,2016,856,1160,0.4246031746031746,0.5753968253968254
23,0.2642463381612313,0.5767086295640655,1999,1321,678,0.6608304152076038,0.3391695847923962
24,0.19340407294860457,0.6346518119879949,1996,1197,799,0.5996993987975952,0.4003006012024048
25,0.06332424537999691,0.6827205084041107,2019,1058,961,0.5240217929668153,0.4759782070331847
26,0.2526298809342336,0.6183991594768338,1997,1267,730,0.6344516775162744,0.3655483224837256
27,-0.03903137073119444,0.712378637222556,2016,935,1081,0.46378968253968256,0.5362103174603174
28,0.02397779015001386,0.653292691084176,1399,667,732,0.4767691208005718,0.5232308791994281
29,0.18967792685731558,0.5994393583787853,1996,1190,806,0.5961923847695391,0.40380761523046094
30,0.05983950779679976,0.628759572156649,1996,975,1021,0.48847695390781565,0.5115230460921844
31,0.07416561507852748,0.5951453647361052,2000,1035,965,0.5175,0.4825
32,0.18921413587173447,0.5571292921877319,2000,1180,820,0.59,0.41
33,0.17645191536387364,0.57863223271888,1319,778,541,0.5898407884761183,0.41015921152388174
34,0.29917306439436026,0.5658616029857398,1924,1286,638,0.6683991683991684,0.3316008316008316
35,0.12087936130952856,0.5451752426702526,1999,1103,896,0.551775887943972,0.448224112056028
36,0.039267039671540264,0.6401833467167213,290,145,145,0.5,0.5
37,0.1942653882696017,0.5808419500171262,1999,1205,794,0.6028014007003502,0.39719859929964985
38,0.26817349317935985,0.5245885103516008,1999,1334,665,0.6673336668334167,0.3326663331665833
39,0.21570863749622882,0.6213121035562686,1996,1255,741,0.6287575150300602,0.3712424849699399
40,0.22485242279020845,0.5583592468662794,1998,1209,789,0.6051051051051051,0.3948948948948949
41,0.017468756683167063,0.597668106140843,1997,930,1067,0.4656985478217326,0.5343014521782674
42,-0.0006402189491140568,0.7083655973958632,1999,975,1024,0.48774387193596797,0.512256128064032
43,0.3408844319984138,0.5720476797954205,1997,1418,579,0.7100650976464697,0.2899349023535303
44,-0.10607680515571502,0.6298291294550341,2010,758,1252,0.37711442786069654,0.6228855721393035
45,0.3111873679785519,0.6274010071873577,1999,1373,626,0.6868434217108554,0.31315657828914456
46,0.20707707693290792,0.551085475727204,1645,995,650,0.6048632218844985,0.3951367781155015
47,0.09741928145075934,0.5769785460203666,1998,1095,903,0.5480480480480481,0.4519519519519519
48,0.2627804174297233,0.6200483953404625,1998,1277,721,0.6391391391391391,0.3608608608608609
49,0.21536874045810486,0.5774113235389027,1997,1198,799,0.599899849774662,0.400100150225338
50,0.18504573992966192,0.629612809780109,1664,994,670,0.5973557692307693,0.4026442307692308
51,0.16545492574319162,0.6580627169832176,1992,1157,835,0.5808232931726908,0.41917670682730923
52,0.007654863653682917,0.6197663419547705,1983,940,1043,0.47402924861321233,0.5259707513867877
54,-0.18708368300002964,0.6452468106049659,558,196,362,0.35125448028673834,0.6487455197132617
55,0.12968682416639643,0.6319156069148675,1997,1144,853,0.5728592889334001,0.4271407110665999
56,0.06654624982449871,0.6802993182077094,1998,1068,930,0.5345345345345346,0.46546546546546547
57,0.10151975239362637,0.6422683343316135,1997,1066,931,0.5338007010515774,0.46619929894842266
58,0.017840618975122634,0.6775892217512036,441,211,230,0.47845804988662133,0.5215419501133787
59,0.11458457148632104,0.677038759658945,519,285,234,0.5491329479768786,0.4508670520231214
60,0.15185561345180762,0.6364298522923166,1003,583,420,0.5812562313060817,0.4187437686939183
61,-0.036415379913460784,0.6210359697317489,1478,671,807,0.4539918809201624,0.5460081190798376
62,0.14772031827130472,0.6530464313086951,1999,1179,820,0.5897948974487244,0.4102051025512756
63,0.23512247700863825,0.5784469460282854,1996,1260,736,0.6312625250501002,0.3687374749498998
64,0.14183037855729136,0.5900447950591404,1284,711,573,0.5537383177570093,0.4462616822429907
65,0.09660222257138172,0.635339443725555,1997,1040,957,0.5207811717576365,0.47921882824236356
66,0.2539638038052765,0.6143549119430044,1996,1267,729,0.6347695390781564,0.3652304609218437
67,0.21969789147451707,0.6511420942941267,1995,1219,776,0.6110275689223058,0.38897243107769425
68,0.25190581015879615,0.6054597069019869,1314,833,481,0.6339421613394216,0.3660578386605784
69,0.05883020065901331,0.6507898176223762,971,498,473,0.5128733264675592,0.48712667353244077
70,-0.3198018747860113,0.6049869046620318,111,31,80,0.27927927927927926,0.7207207207207207
71,0.3533383973220592,0.5552870566343459,1995,1428,567,0.7157894736842105,0.28421052631578947
72,0.22984746319567784,0.5937988678898244,2000,1246,754,0.623,0.377
74,0.020945378133378233,0.6602449920878206,1596,788,808,0.49373433583959897,0.506265664160401
75,-0.09233689288293093,0.6674203294496632,239,101,138,0.4225941422594142,0.5774058577405857
76,-0.30216169449994823,0.5738009922487115,426,117,309,0.2746478873239437,0.7253521126760564
77,-0.08785186748195202,0.6298447979947799,1534,646,888,0.4211212516297262,0.5788787483702738
78,0.1957167918790318,0.6049035297201921,1842,1106,736,0.6004343105320304,0.3995656894679696
79,0.16677557718515734,0.650602629396673,834,503,331,0.6031175059952039,0.39688249400479614
80,-0.09445755306799758,0.6681870199369649,752,320,432,0.425531914893617,0.574468085106383
81,0.40540023694876687,0.5626227921475223,521,393,128,0.7543186180422264,0.2456813819577735
82,0.06474673583764921,0.6495487727012283,165,86,79,0.5212121212121212,0.47878787878787876
83,0.04858533819711833,0.666126074975004,1068,533,535,0.499063670411985,0.5009363295880149
84,0.027883408969501044,0.6762029516357705,32,14,18,0.4375,0.5625
85,0.06274241774898259,0.6547391365706742,961,488,473,0.5078043704474505,0.4921956295525494
86,0.01690474429222592,0.6351874128971389,34,17,17,0.5,0.5
87,-0.18971046032073596,0.6557794025565428,600,196,404,0.32666666666666666,0.6733333333333333
88,-0.15669780880215228,0.5966333595130682,1524,566,958,0.37139107611548555,0.6286089238845144
90,-0.34255752680146656,0.6020562698303318,1316,332,984,0.25227963525835867,0.7477203647416414
91,0.10410995293244883,0.6665072301867293,273,148,125,0.5421245421245421,0.45787545787545786
92,-0.01043549046984741,0.6377559775797327,266,114,152,0.42857142857142855,0.5714285714285714
93,0.014390211782673867,0.5489840669166506,2018,948,1070,0.4697720515361744,0.5302279484638256
94,0.2786408779503824,0.5543972692788223,1210,823,387,0.6801652892561983,0.31983471074380165
95,-0.34726226043167424,0.5517170360881257,238,59,179,0.24789915966386555,0.7521008403361344
96,0.2640558662716908,0.6124954323233813,1994,1249,745,0.6263791374122367,0.3736208625877633
97,-0.3961196052841842,0.6313929749913607,18,5,13,0.2777777777777778,0.7222222222222222
98,0.10668512831845905,0.6369502756415796,339,186,153,0.5486725663716814,0.45132743362831856
99,0.288572520492002,0.5585524019842119,1015,675,340,0.6650246305418719,0.33497536945812806
100,0.13183419540897012,0.5911488726778319,2000,1119,881,0.5595,0.4405
101,0.17610518993917845,0.6209084288600134,569,350,219,0.6151142355008787,0.38488576449912126
102,-0.0003763788910669759,0.6600982175925204,535,240,295,0.4485981308411215,0.5514018691588785
103,0.0945131369933333,0.6348013677032841,877,476,401,0.5427594070695553,0.4572405929304447
104,0.023571329841293506,0.6142607867332621,1521,717,804,0.4714003944773176,0.5285996055226825
105,0.0835061974371298,0.6607169988383319,1036,552,484,0.5328185328185329,0.4671814671814672
106,-0.25260772505727663,0.6148184558819025,1728,526,1202,0.30439814814814814,0.6956018518518519
107,0.08550554695454511,0.6535788704671137,1925,1001,924,0.52,0.48
108,-0.017803018249639677,0.716583773241302,545,252,293,0.46238532110091746,0.5376146788990825
109,0.10662692437664273,0.5707394980429239,523,272,251,0.5200764818355641,0.47992351816443596
110,-0.009334798603524251,0.6911510935140117,385,181,204,0.4701298701298701,0.5298701298701298
111,-0.2417638187099302,0.6593624714902423,1524,496,1028,0.32545931758530183,0.6745406824146981
112,0.10479898584438836,0.6449513997467288,374,214,160,0.5721925133689839,0.42780748663101603
113,0.30124865311362947,0.5945642678345296,1998,1396,602,0.6986986986986987,0.3013013013013013
114,0.12274524425151753,0.5970104535144339,1998,1092,906,0.5465465465465466,0.45345345345345345
115,0.13339230695885565,0.6606799862094921,1682,949,733,0.5642092746730083,0.4357907253269917
116,-0.07495063260942698,0.6947550225010075,125,53,72,0.424,0.576
117,-0.30279106765102287,0.5798643527954869,329,84,245,0.2553191489361702,0.7446808510638298
118,-0.15649398367631576,0.608329039910603,693,259,434,0.37373737373737376,0.6262626262626263
119,0.07949467872676905,0.6007720624016426,320,167,153,0.521875,0.478125
120,-0.22799816003735981,0.5771767858096355,1992,626,1366,0.3142570281124498,0.6857429718875502
121,0.1351236820782632,0.563082593630959,451,250,201,0.5543237250554324,0.44567627494456763
122,0.15968060270239184,0.601001546489558,713,413,300,0.5792426367461431,0.42075736325385693
123,0.025441637187991493,0.5742496230373068,910,455,455,0.5,0.5
124,0.1417281947439489,0.587627333389896,511,293,218,0.5733855185909981,0.42661448140900193
125,0.12768238694407047,0.5872433844954978,420,233,187,0.5547619047619048,0.4452380952380952
126,0.1214098386177472,0.5984653091806531,754,429,325,0.5689655172413793,0.43103448275862066
127,0.28209806849920255,0.6129559166818321,674,445,229,0.6602373887240356,0.3397626112759644
128,-0.2059769842636336,0.6101770966376993,2014,687,1327,0.3411122144985104,0.6588877855014895
129,0.007948854009002863,0.6949838640044281,214,105,109,0.49065420560747663,0.5093457943925234
130,0.20469212211366442,0.6527109870249398,185,113,72,0.6108108108108108,0.3891891891891892
131,0.2707234665604774,0.6106019668033569,2000,1312,688,0.656,0.344
132,0.1673425146770921,0.5619415539930146,1175,742,433,0.6314893617021277,0.36851063829787234
133,0.06597890284189643,0.6525779378588062,1028,544,484,0.5291828793774319,0.4708171206225681
134,0.3486054302083068,0.5709411447384368,465,335,130,0.7204301075268817,0.27956989247311825
135,-0.10624750897998292,0.6703994077076252,913,373,540,0.4085432639649507,0.5914567360350493
136,-0.28453830878799613,0.6146072255581013,1336,363,973,0.2717065868263473,0.7282934131736527
137,0.02421838215010892,0.6868760673102812,984,500,484,0.508130081300813,0.491869918699187
138,-0.2846800584153945,0.6564104410088437,223,69,154,0.3094170403587444,0.6905829596412556
139,0.3405047832252679,0.5780057993850087,1094,783,311,0.7157221206581352,0.2842778793418647
140,0.10399600150061385,0.5730903154988372,828,459,369,0.5543478260869565,0.44565217391304346
141,0.1570435878466953,0.6313133142585452,1211,689,522,0.5689512799339389,0.4310487200660611
142,0.15226696017406768,0.558726600857159,670,386,284,0.5761194029850746,0.42388059701492536
143,0.12157371653057635,0.667126191557542,2000,1166,834,0.583,0.417
144,0.27784778971706775,0.6233044233450126,1013,674,339,0.6653504442250741,0.33464955577492594
145,0.024756012145126384,0.560216918444126,1780,870,910,0.4887640449438202,0.5112359550561798
146,0.013952555996836207,0.6384074140152326,396,195,201,0.49242424242424243,0.5075757575757576
147,0.18063117313504518,0.6440331952036573,399,247,152,0.6190476190476191,0.38095238095238093
148,-0.20633504797893085,0.6413588593309506,1294,440,854,0.3400309119010819,0.6599690880989181
149,0.037123328689485785,0.6512036237187951,550,291,259,0.5290909090909091,0.4709090909090909
150,-0.001045576626060543,0.6410004037626921,806,395,411,0.49007444168734493,0.5099255583126551
151,-0.026001366074299176,0.631312777860776,319,158,161,0.4952978056426332,0.5047021943573667
152,-0.19700137402704554,0.6022418878260092,1346,444,902,0.3298662704309064,0.6701337295690936
153,0.08932800664491608,0.6007606301894857,759,415,344,0.546772068511199,0.45322793148880103
154,0.04053669383058384,0.692521980018458,372,185,187,0.49731182795698925,0.5026881720430108
155,0.26575015258565393,0.5749712738167697,1997,1320,677,0.6609914872308462,0.3390085127691537
156,0.06567895440384745,0.659152641708108,420,220,200,0.5238095238095238,0.47619047619047616
157,0.11600096034750429,0.6241867278755069,1043,590,453,0.5656759348034516,0.4343240651965484
158,0.12416677241211449,0.6782885596710126,429,244,185,0.5687645687645687,0.43123543123543123
159,0.3464259767362695,0.5848222036333318,1996,1405,591,0.7039078156312625,0.29609218436873747
160,0.10139729525270309,0.6527881634035666,227,128,99,0.5638766519823789,0.43612334801762115
161,0.09349251116909307,0.7167612563400444,779,431,348,0.5532734274711169,0.4467265725288832
162,0.3265994741950029,0.5549080160324831,480,336,144,0.7,0.3
163,0.15837676738761666,0.6139241096437803,617,368,249,0.5964343598055105,0.4035656401944895
164,0.10106058889825865,0.61998052397542,1273,683,590,0.5365278868813825,0.4634721131186174
165,0.12260415747823163,0.6125357427875308,667,377,290,0.5652173913043478,0.43478260869565216
166,0.06040341783126321,0.5536769259710527,158,77,81,0.4873417721518987,0.5126582278481012
167,0.1406129822183478,0.6152914912332069,384,216,168,0.5625,0.4375
168,-0.1113862193448262,0.6862756597229751,180,77,103,0.42777777777777776,0.5722222222222222
169,0.12060048541223461,0.5493495034832556,1122,615,507,0.5481283422459893,0.45187165775401067
170,0.15938487545464913,0.622921412126745,1105,661,444,0.5981900452488688,0.40180995475113124
171,0.07273502970978035,0.6158284351972121,179,93,86,0.5195530726256983,0.48044692737430167
172,0.12530321656143137,0.5303411399288028,1498,851,647,0.568090787716956,0.4319092122830441
173,-0.21520440417556014,0.5693385647449127,722,221,501,0.3060941828254848,0.6939058171745153
174,0.24101771643956701,0.5750218862969348,753,502,251,0.6666666666666666,0.3333333333333333
175,0.15089251383242555,0.6593330612396411,642,358,284,0.557632398753894,0.4423676012461059
176,0.15422165651485908,0.687934865316532,1992,1118,874,0.5612449799196787,0.4387550200803213
177,-0.2829859785544838,0.5584162728111736,703,185,518,0.2631578947368421,0.7368421052631579
178,-0.07322158558028082,0.4380198641870704,7,3,4,0.42857142857142855,0.5714285714285714
179,0.1438191359930703,0.6177926569629966,356,206,150,0.5786516853932584,0.42134831460674155
180,0.14019773374047872,0.5816143361858215,1024,593,431,0.5791015625,0.4208984375
181,0.10053446277763588,0.6121190504347951,1999,1099,900,0.5497748874437218,0.4502251125562781
182,-0.003562878872594338,0.5508073028272122,893,390,503,0.43673012318029114,0.5632698768197089
183,-0.5375185309288403,0.3559876832717824,12,1,11,0.08333333333333333,0.9166666666666666
184,-0.25140277332151734,0.6014829004137289,1729,525,1204,0.30364372469635625,0.6963562753036437
185,-0.1534158327187339,0.6339089548919425,167,62,105,0.3712574850299401,0.6287425149700598
186,-0.13000706336298837,0.6775166620261098,402,154,248,0.38308457711442784,0.6169154228855721
187,0.08504319867358527,0.5340202475900219,358,189,169,0.5279329608938548,0.4720670391061452
188,0.08346141111839181,0.6337434491539905,838,465,373,0.5548926014319809,0.4451073985680191
189,0.12371895077062141,0.6176557540156916,257,128,129,0.4980544747081712,0.5019455252918288
190,0.2711998003105691,0.543344973970656,256,172,84,0.671875,0.328125
191,0.34674318597595,0.5721955876617502,98,68,30,0.6938775510204082,0.30612244897959184
192,0.26959889133399473,0.6048036528295313,167,111,56,0.6646706586826348,0.33532934131736525
193,0.11134107865260116,0.5892580006503636,140,78,62,0.5571428571428572,0.44285714285714284
194,0.09092706545805834,0.5933220305923639,371,204,167,0.5498652291105122,0.4501347708894879
195,-0.5315270110964775,0.36112699766361106,5,1,4,0.2,0.8
196,0.27480873235422,0.603083284350965,223,154,69,0.6905829596412556,0.3094170403587444
197,-0.30113193675651584,0.6244786566121654,133,38,95,0.2857142857142857,0.7142857142857143
198,0.12444864914160718,0.5838587152420167,1015,566,449,0.5576354679802956,0.44236453201970444
199,0.06473167917157902,0.6122722903924349,613,314,299,0.5122349102773246,0.48776508972267535
200,-0.07894742663710246,0.6476626687375822,1750,736,1014,0.4205714285714286,0.5794285714285714
201,-0.22872611889791378,0.6730527840667111,265,97,168,0.3660377358490566,0.6339622641509434
202,0.0835721428338133,0.6731011537114698,61,35,26,0.5737704918032787,0.4262295081967213
203,0.036921135593859955,0.5683869629271163,279,135,144,0.4838709677419355,0.5161290322580645
204,-0.16572055896107532,0.6513990139190174,237,89,148,0.3755274261603376,0.6244725738396625
205,-0.15426961156791535,0.672696527527059,732,293,439,0.40027322404371585,0.5997267759562842
206,0.20136082187198792,0.6993106668240825,736,454,282,0.6168478260869565,0.38315217391304346
207,0.07429069310698348,0.6858772274283623,192,105,87,0.546875,0.453125
208,0.06759175095109876,0.6412495274054235,237,127,110,0.5358649789029536,0.4641350210970464
209,0.17947462609719853,0.6325036437904077,710,428,282,0.6028169014084507,0.3971830985915493
210,0.05595804264932774,0.5664624416345658,307,156,151,0.50814332247557,0.49185667752442996
211,-0.07817821094596927,0.6290380090193469,264,113,151,0.42803030303030304,0.571969696969697
212,0.400043602632005,0.5904409315706605,79,58,21,0.7341772151898734,0.26582278481012656
213,0.32232182102250684,0.5499853841050387,1370,983,387,0.7175182481751825,0.2824817518248175
214,0.34784812904713464,0.5562825259757531,1421,1012,409,0.7121745249824067,0.28782547501759326
215,-0.009380698952750833,0.6039881899306513,255,121,134,0.4745098039215686,0.5254901960784314
216,-0.21349863790641407,0.60612386299269,1245,420,825,0.3373493975903614,0.6626506024096386
217,-0.18878988376153366,0.6944625495225619,182,70,112,0.38461538461538464,0.6153846153846154
218,0.0935015674575892,0.7094067172278408,659,345,314,0.5235204855842185,0.4764795144157815
219,0.30987303332574123,0.5709313891014828,690,470,220,0.6811594202898551,0.3188405797101449
220,-0.148598763755824,0.605807451581733,1981,726,1255,0.36648157496214034,0.6335184250378597
221,-0.37286220170286166,0.589549524688144,254,55,199,0.21653543307086615,0.7834645669291339
222,0.09051291855925013,0.5998131803675205,271,142,129,0.5239852398523985,0.47601476014760147
223,0.2881707987794512,0.6140301137486873,662,439,223,0.6631419939577039,0.3368580060422961
224,0.3230984043966756,0.5425776049381928,117,84,33,0.717948717948718,0.28205128205128205
225,0.16135356320418553,0.531316694238278,436,262,174,0.6009174311926605,0.39908256880733944
226,-0.1368126029144455,0.6777889716759008,439,175,264,0.39863325740318906,0.6013667425968109
227,-0.10224019991116481,0.6656373263252989,222,86,136,0.38738738738738737,0.6126126126126126
228,0.16610135463787015,0.6237308081855754,221,129,92,0.583710407239819,0.416289592760181
229,-0.3714289231042501,0.5525545672764584,447,99,348,0.2214765100671141,0.7785234899328859
230,0.20032542523014377,0.5614797188533519,631,378,253,0.5990491283676703,0.4009508716323296
231,0.35492256741002626,0.6094531293630728,354,268,86,0.7570621468926554,0.24293785310734464
232,-0.059457946863272285,0.6387476821068413,332,143,189,0.4307228915662651,0.5692771084337349
233,0.04635646539440347,0.5949253859620869,590,301,289,0.5101694915254237,0.48983050847457626
234,0.19030481162444343,0.5939834181497812,1270,780,490,0.6141732283464567,0.3858267716535433
235,-0.12525534292416912,0.5742717383080386,175,69,106,0.3942857142857143,0.6057142857142858
236,0.02713566524941568,0.6470397970856349,277,139,138,0.5018050541516246,0.4981949458483754
237,0.09582972543706235,0.7209183842354491,38,20,18,0.5263157894736842,0.47368421052631576
238,-0.21909874408445085,0.6335035980142214,567,187,380,0.3298059964726631,0.6701940035273368
239,0.2007904661218572,0.5941232030780388,1389,865,524,0.6227501799856011,0.37724982001439883
240,0.3700058480878924,0.5000147119638523,314,242,72,0.7707006369426752,0.22929936305732485
241,-0.3816835366931737,0.5259725056687525,133,32,101,0.24060150375939848,0.7593984962406015
242,0.128749210753668,0.6088817132113493,206,117,89,0.5679611650485437,0.4320388349514563
243,0.11703102626919622,0.595564043443803,478,271,207,0.5669456066945606,0.4330543933054393
244,0.22494681336534902,0.5930434713160325,156,98,58,0.6282051282051282,0.3717948717948718
245,0.08608705841219254,0.6808276998968879,139,73,66,0.5251798561151079,0.4748201438848921
246,0.05090380136007995,0.690188326180416,287,133,154,0.4634146341463415,0.5365853658536586
247,0.1117298101512388,0.6392247351195415,313,173,140,0.5527156549520766,0.4472843450479233
248,-0.043993739404534694,0.7045852165119983,139,63,76,0.45323741007194246,0.5467625899280576
249,-0.21508079292304114,0.5544719008023843,1991,628,1363,0.31541938724259166,0.6845806127574083
250,0.3273690960601352,0.6149293552259388,157,117,40,0.7452229299363057,0.25477707006369427
251,0.09142205078197704,0.6573063623249128,521,286,235,0.5489443378119002,0.4510556621880998
252,0.12094918517258894,0.5728379235745739,272,155,117,0.5698529411764706,0.43014705882352944
253,0.00458085539274558,0.5655897083786493,221,111,110,0.502262443438914,0.497737556561086
254,0.32740934791279513,0.5481842456510876,213,150,63,0.704225352112676,0.29577464788732394
255,-0.07577734515977513,0.6320398685527108,226,97,129,0.42920353982300885,0.5707964601769911
256,-0.24620487624114112,0.612004864094218,168,54,114,0.32142857142857145,0.6785714285714286
257,0.06463470903690904,0.5283742952011579,552,261,291,0.47282608695652173,0.5271739130434783
259,-0.09057821697192572,0.6051711000963509,213,91,122,0.4272300469483568,0.5727699530516432
260,-0.16780267901814136,0.6519760106637089,78,30,48,0.38461538461538464,0.6153846153846154
261,0.039124478845399595,0.6263101408282502,456,226,230,0.4956140350877193,0.5043859649122807
262,-0.2738960159720764,0.5713129693860701,210,56,154,0.26666666666666666,0.7333333333333333
263,0.11209600680283091,0.6600104039822202,369,203,166,0.5501355013550135,0.44986449864498645
264,-0.023785310711613616,0.6837663170316397,228,108,120,0.47368421052631576,0.5263157894736842
265,0.05018009316428737,0.638880176940246,59,32,27,0.5423728813559322,0.4576271186440678
266,-0.13552381449379028,0.617957113125224,100,38,62,0.38,0.62
267,-0.07783255658459164,0.6765763429727744,137,64,73,0.46715328467153283,0.5328467153284672
268,0.10060506724548443,0.5984932935166576,461,259,202,0.561822125813449,0.43817787418655096
269,0.07925915192683694,0.6573573909706055,1213,655,558,0.5399835119538334,0.4600164880461665
270,-0.06368721062263658,0.6410685841861273,173,74,99,0.4277456647398844,0.5722543352601156
271,-0.1795966535913799,0.603625802520321,226,81,145,0.3584070796460177,0.6415929203539823
272,-0.012757037702555719,0.6959433533986843,665,324,341,0.48721804511278194,0.512781954887218
273,0.4922426006217536,0.5166801792552669,76,61,15,0.8026315789473685,0.19736842105263158
274,0.2736625143566475,0.660629881028236,307,203,104,0.6612377850162866,0.33876221498371334
275,0.06762852429367629,0.5913585178916585,271,137,134,0.5055350553505535,0.4944649446494465
276,-0.41362397046759725,0.48951432306632603,20,5,15,0.25,0.75
277,0.07635505709935117,0.5843108019665425,135,70,65,0.5185185185185185,0.48148148148148145
278,-0.26148713998259066,0.5193874870295203,1255,334,921,0.2661354581673307,0.7338645418326694
279,0.017942382488399737,0.597707271925223,96,47,49,0.4895833333333333,0.5104166666666666
280,-0.15110429937181916,0.5565495764342613,92,35,57,0.3804347826086957,0.6195652173913043
281,-0.08276279830839485,0.5653006036273093,200,80,120,0.4,0.6
282,0.14484568077692372,0.5568635475009571,187,99,88,0.5294117647058824,0.47058823529411764
283,0.022929372227529884,0.541346420719596,97,44,53,0.4536082474226804,0.5463917525773195
284,0.25112416599341464,0.6437267024056518,452,282,170,0.6238938053097345,0.37610619469026546
285,0.24601299467974821,0.5922326789019193,592,373,219,0.6300675675675675,0.36993243243243246
286,-0.034967534717113266,0.6810988526534166,63,30,33,0.47619047619047616,0.5238095238095238
287,-0.05054581325642671,0.6716270912068185,158,68,90,0.43037974683544306,0.569620253164557
288,0.12205073813336992,0.5006680009103448,310,173,137,0.5580645161290323,0.44193548387096776
289,-0.14779433539101425,0.6742056249591463,1560,627,933,0.40192307692307694,0.5980769230769231
290,-0.04385424358575414,0.6722133317768496,239,110,129,0.4602510460251046,0.5397489539748954
291,-0.07917672919873626,0.6747304735794056,78,33,45,0.4230769230769231,0.5769230769230769
292,-0.5357983452267945,0.4171211085919914,8,1,7,0.125,0.875
293,0.3424444159072253,0.5132247993043016,465,347,118,0.7462365591397849,0.2537634408602151
294,0.28356857629825366,0.565026333885091,1042,702,340,0.6737044145873321,0.32629558541266795
295,-0.1057999189920795,0.7114429937777682,209,87,122,0.41626794258373206,0.583732057416268
296,-0.017740361811300308,0.6762759061081491,318,152,166,0.4779874213836478,0.5220125786163522
297,-0.04783380562938482,0.7223757983175378,112,55,57,0.49107142857142855,0.5089285714285714
298,0.21819718325794335,0.6041104858702304,151,94,57,0.6225165562913907,0.37748344370860926
299,0.18343146597246893,0.5851164578390823,176,112,64,0.6363636363636364,0.36363636363636365
300,-0.23027772003916477,0.632788766862776,198,65,133,0.3282828282828283,0.6717171717171717
301,-0.10176227885972837,0.6787408548428954,145,57,88,0.3931034482758621,0.6068965517241379
302,-0.14684672493183012,0.5934061046662952,159,67,92,0.42138364779874216,0.5786163522012578
303,0.13626655518339995,0.6029596499382472,78,43,35,0.5512820512820513,0.44871794871794873
304,-0.013754470293528174,0.650714794187253,142,71,71,0.5,0.5
305,0.056128439392362325,0.6376337673120361,350,185,165,0.5285714285714286,0.4714285714285714
306,0.1963352936503028,0.6665797600000378,402,241,161,0.599502487562189,0.40049751243781095
307,0.37098982032374067,0.5667725474680886,1295,958,337,0.7397683397683398,0.2602316602316602
308,0.2455125799934779,0.6376452839790047,105,64,41,0.6095238095238096,0.3904761904761905
310,0.006113430036714787,0.6523881851416181,162,78,84,0.48148148148148145,0.5185185185185185
311,-0.2854113976160686,0.5921487225316819,3,1,2,0.3333333333333333,0.6666666666666666
312,0.0398666546651465,0.5197149951627505,163,76,87,0.4662576687116564,0.5337423312883436
313,0.04935136655795163,0.6057050559632375,87,43,44,0.4942528735632184,0.5057471264367817
314,-0.27511560578433863,0.6550867347800227,108,37,71,0.3425925925925926,0.6574074074074074
315,0.2477843304685756,0.5176642374005775,681,442,239,0.6490455212922174,0.3509544787077827
316,0.022707953101370294,0.593101919725277,312,154,158,0.4935897435897436,0.5064102564102564
317,-0.056121600506603975,0.6583982756818992,609,285,324,0.46798029556650245,0.5320197044334976
318,0.006119752284855793,0.6406694801743389,416,207,209,0.49759615384615385,0.5024038461538461
319,0.07521227070641132,0.6108361155318733,155,87,68,0.5612903225806452,0.43870967741935485
320,0.07875514880947347,0.5979444868304227,159,78,81,0.49056603773584906,0.5094339622641509
321,0.4622002692866913,0.5309825301435739,142,114,28,0.8028169014084507,0.19718309859154928
322,0.1388921922489849,0.5896061279886614,393,234,159,0.5954198473282443,0.40458015267175573
323,-0.23712684800848366,0.6234933562633057,60,16,44,0.26666666666666666,0.7333333333333333
324,-0.36323547861637906,0.5765775805489762,94,21,73,0.22340425531914893,0.776595744680851
325,0.043789480738933115,0.5455208189654618,63,32,31,0.5079365079365079,0.49206349206349204
326,-0.3540950474976483,0.5336716287707176,59,14,45,0.23728813559322035,0.7627118644067796
327,0.10814456389558436,0.6782344884945475,495,267,228,0.5393939393939394,0.46060606060606063
328,0.07154337335377933,0.6648078978119043,30,18,12,0.6,0.4
329,0.009549226727710958,0.5904718060626524,209,102,107,0.4880382775119617,0.5119617224880383
330,-0.25774030246201063,0.6750790838283155,31,10,21,0.3225806451612903,0.6774193548387096
331,0.018951765061247825,0.6576757658176339,172,87,85,0.5058139534883721,0.4941860465116279
332,-0.28348523207447107,0.5526321008938962,170,48,122,0.2823529411764706,0.7176470588235294
333,-0.2540835977312835,0.5738854323004061,68,22,46,0.3235294117647059,0.6764705882352942
334,-0.32676150401433307,0.29704356787263425,3,1,2,0.3333333333333333,0.6666666666666666
335,0.1452011650907669,0.6357550505486098,303,170,133,0.5610561056105611,0.4389438943894389
336,0.0992173556400382,0.5276448331133737,230,118,112,0.5130434782608696,0.48695652173913045
337,0.26944769872089397,0.608239221583981,177,121,56,0.6836158192090396,0.3163841807909605
338,0.0565749397628928,0.4960032613156719,73,35,38,0.4794520547945205,0.5205479452054794
339,0.20430448966632997,0.6276633934902747,140,85,55,0.6071428571428571,0.39285714285714285
340,0.1795295963425245,0.5147908980950094,67,34,33,0.5074626865671642,0.4925373134328358
341,-0.18972726584105018,0.6514279112917251,376,143,233,0.3803191489361702,0.6196808510638298
342,0.23347946774140982,0.5738161993817391,152,93,59,0.6118421052631579,0.3881578947368421
343,0.3703857857581912,0.5775017838186011,196,142,54,0.7244897959183674,0.2755102040816326
344,0.0608857598147033,0.6371141185156608,214,110,104,0.514018691588785,0.48598130841121495
345,-0.19088416148883267,0.5946678723682077,37,14,23,0.3783783783783784,0.6216216216216216
346,-0.16672163464622025,0.6629984245901738,170,61,109,0.3588235294117647,0.6411764705882353
347,-0.29413139702547797,0.5967835023741483,656,185,471,0.2820121951219512,0.7179878048780488
348,0.25605317123998433,0.5470364375957023,39,27,12,0.6923076923076923,0.3076923076923077
349,-0.3477228526294661,0.5114557408508965,104,22,82,0.21153846153846154,0.7884615384615384
350,0.10298895590691544,0.653828979132786,49,25,24,0.5102040816326531,0.4897959183673469
351,0.1652368168166328,0.6710329528324339,62,38,24,0.6129032258064516,0.3870967741935484
352,0.36412721084092153,0.531872295638019,110,78,32,0.7090909090909091,0.2909090909090909
353,0.016036419591568794,0.6665339006004962,194,105,89,0.5412371134020618,0.4587628865979381
354,-0.05474562305552919,0.6824325978283063,212,94,118,0.44339622641509435,0.5566037735849056
355,0.3308928608416747,0.5901925979959441,351,254,97,0.7236467236467237,0.27635327635327633
356,-0.030273520466412462,0.627503365080882,71,33,38,0.4647887323943662,0.5352112676056338
357,0.01717439115199508,0.6043227127671282,49,25,24,0.5102040816326531,0.4897959183673469
358,0.20902429231657432,0.5918053503413389,520,330,190,0.6346153846153846,0.36538461538461536
359,-0.0336430857639087,0.5846022958807093,227,97,130,0.42731277533039647,0.5726872246696035
360,-0.12904035897347435,0.6661534297641509,87,37,50,0.42528735632183906,0.5747126436781609
361,0.03521581689710729,0.6150495221439473,128,65,63,0.5078125,0.4921875
362,0.14200644872530743,0.5287889177254755,135,78,57,0.5777777777777777,0.4222222222222222
363,0.06184981725058488,0.5471471871281879,496,255,241,0.5141129032258065,0.48588709677419356
364,0.3018955007126486,0.5675906202071254,54,38,16,0.7037037037037037,0.2962962962962963
365,0.036803876822240546,0.6327729390322233,211,107,104,0.5071090047393365,0.4928909952606635
366,0.08774067878561176,0.5723375104074598,92,50,42,0.5434782608695652,0.45652173913043476
367,-0.11387987205137809,0.5355682695839412,90,33,57,0.36666666666666664,0.6333333333333333
368,0.13622989878058436,0.5736767787008558,47,27,20,0.574468085106383,0.425531914893617
369,0.24901533781273946,0.6124627100832055,74,50,24,0.6756756756756757,0.32432432432432434
370,0.15676686264363662,0.635196586914746,53,32,21,0.6037735849056604,0.39622641509433965
371,0.2510596006915047,0.541856521136507,202,130,72,0.6435643564356436,0.3564356435643564
372,-0.028389496614738382,0.6425103314071627,98,47,51,0.47959183673469385,0.5204081632653061
373,-0.3184540119707688,0.5897946161918328,72,18,54,0.25,0.75
374,-0.04448282587513023,0.7159944739861905,98,48,50,0.4897959183673469,0.5102040816326531
375,-0.15439412859087998,0.6565485727553019,129,50,79,0.3875968992248062,0.6124031007751938
376,-0.08503916479443036,0.6664065161168959,73,30,43,0.410958904109589,0.589041095890411
377,-0.06381754232022695,0.6735972306244046,17,8,9,0.47058823529411764,0.5294117647058824
378,-0.21941354631135865,0.5979951393733403,75,30,45,0.4,0.6
379,-0.015195513135265742,0.6409583193697077,315,146,169,0.4634920634920635,0.5365079365079365
380,-0.30451439688055726,0.5616545307967526,152,42,110,0.27631578947368424,0.7236842105263158
381,0.23536898624882394,0.6021193771210672,51,31,20,0.6078431372549019,0.39215686274509803
382,0.29172171238664685,0.5878055737011483,385,268,117,0.6961038961038961,0.3038961038961039
383,-0.04705063933343219,0.6474377147062488,57,25,32,0.43859649122807015,0.5614035087719298
384,-0.10179056895568091,0.6199916488164742,17,7,10,0.4117647058823529,0.5882352941176471
385,-0.730451743428906,0.3947402626562154,3,0,3,0.0,1.0
386,0.003833023017073186,0.6575829539665922,159,74,85,0.46540880503144655,0.5345911949685535
387,0.045071521415733375,0.631143656639962,26,14,12,0.5384615384615384,0.46153846153846156
388,-0.21395468159634792,0.6759986731363115,432,150,282,0.3472222222222222,0.6527777777777778
389,0.0041556543243738515,0.7353655948041812,144,71,73,0.4930555555555556,0.5069444444444444
390,0.22819001780590042,0.49163040613056547,64,44,20,0.6875,0.3125
391,0.08549437549424498,0.559323695061823,73,38,35,0.5205479452054794,0.4794520547945205
392,0.0027777076767826667,0.6979180301957615,54,23,31,0.42592592592592593,0.5740740740740741
393,-0.20221015210780835,0.6859610225660591,18,7,11,0.3888888888888889,0.6111111111111112
394,0.33240788653768,0.5947413474324627,474,337,137,0.7109704641350211,0.2890295358649789
395,0.24964419868500792,0.5452769827000601,85,53,32,0.6235294117647059,0.3764705882352941
396,0.12450444515073492,0.5972171907874312,93,50,43,0.5376344086021505,0.46236559139784944
397,-0.00876284360584586,0.6536597669474495,99,48,51,0.48484848484848486,0.5151515151515151
398,-0.03011714713647959,0.6545054437101965,16,8,8,0.5,0.5
399,-0.20047300160718215,0.6006127110285562,71,21,50,0.29577464788732394,0.704225352112676
400,-0.2999728694558144,0.5795918010350929,17,4,13,0.23529411764705882,0.7647058823529411
401,-0.1056980435969308,0.5914548346563552,32,13,19,0.40625,0.59375
402,0.27712973181543676,0.5183402662681849,29,19,10,0.6551724137931034,0.3448275862068966
403,-0.054429496670591423,0.641972288172722,87,36,51,0.41379310344827586,0.5862068965517241
404,0.264162406232208,0.5204008793233074,120,79,41,0.6583333333333333,0.3416666666666667
405,0.08108060966644969,0.5395377596027714,112,58,54,0.5178571428571429,0.48214285714285715
406,0.05118448744356936,0.6102569541234154,196,104,92,0.5306122448979592,0.46938775510204084
407,0.01854705773293972,0.6323724627886326,120,56,64,0.4666666666666667,0.5333333333333333
408,-0.2538034874945879,0.5193780600736636,50,15,35,0.3,0.7
409,0.22837519752404964,0.5802950319825849,48,31,17,0.6458333333333334,0.3541666666666667
410,0.09310336894751026,0.6887800250768713,139,78,61,0.5611510791366906,0.43884892086330934
411,-0.004606393123553565,0.5648847341346458,44,18,26,0.4090909090909091,0.5909090909090909
412,0.39081510965680255,0.5430939373638796,29,22,7,0.7586206896551724,0.2413793103448276
413,-0.2673492495362696,0.5679884894022766,19,7,12,0.3684210526315789,0.631578947368421
414,0.12016597293972314,0.6014266532939426,91,50,41,0.5494505494505495,0.45054945054945056
415,-0.01992137396130069,0.5430065894502911,29,17,12,0.5862068965517241,0.41379310344827586
416,-0.09396501227568549,0.6270289566545796,104,45,59,0.4326923076923077,0.5673076923076923
417,0.42048015466166866,0.5454172754481891,18,15,3,0.8333333333333334,0.16666666666666666
418,0.27861018463348347,0.5917884963758728,48,34,14,0.7083333333333334,0.2916666666666667
419,0.2575276075114237,0.535314587502181,305,211,94,0.6918032786885245,0.3081967213114754
420,0.09856591410934926,0.4147325293271625,20,12,8,0.6,0.4
421,0.17731934385845363,0.603905903826937,929,548,381,0.589881593110872,0.4101184068891281
422,0.08161288818739582,0.7150885070493938,33,18,15,0.5454545454545454,0.45454545454545453
423,0.2698350149919005,0.5238086028320164,102,65,37,0.6372549019607843,0.3627450980392157
424,0.12200326506644185,0.6182046707331889,247,142,105,0.5748987854251012,0.4251012145748988
425,-0.36149227361948716,0.5580267087143086,21,5,16,0.23809523809523808,0.7619047619047619
426,0.21437256350632636,0.5183797018107512,93,61,32,0.6559139784946236,0.34408602150537637
427,-0.2027006873632876,0.5352895863868519,686,227,459,0.33090379008746357,0.6690962099125365
428,0.24172836833943923,0.6704025111133872,45,29,16,0.6444444444444445,0.35555555555555557
429,-0.2749467931687832,0.592755152784263,15,5,10,0.3333333333333333,0.6666666666666666
430,0.13438460893440443,0.6054711294239518,61,34,27,0.5573770491803278,0.4426229508196721
431,0.44255665112569026,0.5493084466744993,66,51,15,0.7727272727272727,0.22727272727272727
432,0.04848785521952731,0.5576661652712269,19,9,10,0.47368421052631576,0.5263157894736842
433,0.10648956444898719,0.6399104795432524,95,53,42,0.5578947368421052,0.4421052631578947
434,-0.46646634363569317,0.5585700812478043,60,9,51,0.15,0.85
435,-0.30006517631362284,0.6009616612326483,124,34,90,0.27419354838709675,0.7258064516129032
436,0.18919095096106714,0.5119546641557907,26,15,11,0.5769230769230769,0.4230769230769231
437,0.0978500228729986,0.5613601343605511,105,58,47,0.5523809523809524,0.44761904761904764
438,-0.012363537278925559,0.7535220694880684,29,15,14,0.5172413793103449,0.4827586206896552
439,-0.3025144711136818,0.4348805500724862,2,1,1,0.5,0.5
440,-0.02526415740869131,0.6007148039316416,83,39,44,0.46987951807228917,0.5301204819277109
441,-0.4736390836875547,0.4734113072390872,11,2,9,0.18181818181818182,0.8181818181818182
442,-0.228640394906203,0.9676497587087419,3,1,2,0.3333333333333333,0.6666666666666666
443,0.20473774083490884,0.6107927888302648,14,10,4,0.7142857142857143,0.2857142857142857
444,0.3141593339852989,0.5787359393433775,40,29,11,0.725,0.275
445,-0.27656993761724025,0.5430162722826942,57,12,45,0.21052631578947367,0.7894736842105263
446,-0.20761328698488093,0.6144940625797888,119,40,79,0.33613445378151263,0.6638655462184874
447,0.03225884338219963,0.6073529070531923,27,12,15,0.4444444444444444,0.5555555555555556
448,0.11106099081442454,0.5764327995335043,623,358,265,0.5746388443017657,0.42536115569823435
449,0.1402817127743253,0.6111317107762853,81,46,35,0.5679012345679012,0.43209876543209874
450,-0.05520681291818621,0.4311033459539649,6,2,4,0.3333333333333333,0.6666666666666666
451,-0.48564447541362965,0.6581949365406867,13,2,11,0.15384615384615385,0.8461538461538461
452,-0.43435581937513273,0.5766919001664297,23,4,19,0.17391304347826086,0.8260869565217391
453,-0.0013547167181968897,0.4183253870803925,8,3,5,0.375,0.625
454,0.171127341584199,0.6470959949672546,81,48,33,0.5925925925925926,0.4074074074074074
455,0.19223813871469567,0.6680454974847997,85,51,34,0.6,0.4
456,0.13066875655204058,0.6346556053843938,62,40,22,0.6451612903225806,0.3548387096774194
457,0.3702772041495011,0.5715348218230141,123,90,33,0.7317073170731707,0.2682926829268293
458,-0.4131622393067707,0.5781741651143212,34,7,27,0.20588235294117646,0.7941176470588235
459,0.1673375004902482,0.4536540566487187,12,8,4,0.6666666666666666,0.3333333333333333
460,0.4719473377668432,0.2981313059082539,7,7,0,1.0,0.0
461,-0.2681007073260844,0.5810973099471796,30,9,21,0.3,0.7
462,0.2058109790729038,0.5689882141726579,58,33,25,0.5689655172413793,0.43103448275862066
463,-0.1343790359262909,0.6777756510458843,56,21,35,0.375,0.625
464,0.183073166129072,0.6119290094949145,217,132,85,0.6082949308755761,0.391705069124424
465,-0.07140397116103593,0.5222607743753205,17,5,12,0.29411764705882354,0.7058823529411765
466,-0.10352575347511746,0.500291914997173,98,34,64,0.3469387755102041,0.6530612244897959
467,0.19127388671040535,0.4987577546288365,55,34,21,0.6181818181818182,0.38181818181818183
468,0.2814124145979683,0.6526779298750762,75,52,23,0.6933333333333334,0.30666666666666664
469,-0.02594092632738912,0.485707048425959,49,22,27,0.4489795918367347,0.5510204081632653
470,-0.44073131914924957,0.49121365982911946,58,10,48,0.1724137931034483,0.8275862068965517
471,0.3878885863576921,0.5916234163876147,147,111,36,0.7551020408163265,0.24489795918367346
472,-0.3026352096349001,0.6718686105799516,5,2,3,0.4,0.6
473,-0.22227163516753726,0.6617489383026748,63,21,42,0.3333333333333333,0.6666666666666666
474,0.23289591015169495,0.4787711042221951,19,13,6,0.6842105263157895,0.3157894736842105
475,0.25265102344069706,0.630428970881948,47,29,18,0.6170212765957447,0.3829787234042553
476,0.3687334892729038,0.4977484316672987,158,118,40,0.7468354430379747,0.25316455696202533
477,-0.26450075705846154,0.733803996486523,3,1,2,0.3333333333333333,0.6666666666666666
478,0.13344123894866142,0.6694673370080338,72,43,29,0.5972222222222222,0.4027777777777778
479,0.4725908643805084,0.5419326570018094,678,544,134,0.8023598820058997,0.1976401179941003
480,0.24539513420313597,0.6355415300579987,16,11,5,0.6875,0.3125
481,-0.03441797357052565,0.5990496256478139,50,19,31,0.38,0.62
482,0.012620032764971256,0.5341304410343232,96,48,48,0.5,0.5
483,0.2605695792660117,0.6137673515622477,50,33,17,0.66,0.34
484,0.02782941139183748,0.515918524616665,78,38,40,0.48717948717948717,0.5128205128205128
485,0.06926985889427609,0.6180247289674939,91,49,42,0.5384615384615384,0.46153846153846156
486,0.03701516985893244,0.5580814959121099,4,2,2,0.5,0.5
487,-0.4703335145674646,0.4666629168840492,50,8,42,0.16,0.84
488,-0.004102148513563649,0.6917339395942677,110,53,57,0.4818181818181818,0.5181818181818182
489,0.12667590779095114,0.5618575282452808,385,210,175,0.5454545454545454,0.45454545454545453
490,-0.10112564964219926,0.655514227875532,22,9,13,0.4090909090909091,0.5909090909090909
491,-0.21241024752859683,0.5756374266931059,68,22,46,0.3235294117647059,0.6764705882352942
492,0.2841837596765646,0.5903937968434916,178,120,58,0.6741573033707865,0.3258426966292135
493,0.09405954457495523,0.5135858263685786,46,22,24,0.4782608695652174,0.5217391304347826
494,0.2614650359210461,0.5880429735345161,67,45,22,0.6716417910447762,0.3283582089552239
495,0.09248526610041923,0.6024664264800916,19,9,10,0.47368421052631576,0.5263157894736842
496,0.09102873743644782,0.606448599480332,14,7,7,0.5,0.5
497,0.03668525881533114,0.6640145153442598,21,12,9,0.5714285714285714,0.42857142857142855
498,0.42953937086794114,0.4461666908424151,18,14,4,0.7777777777777778,0.2222222222222222
499,0.17075112663410807,0.5188618673991601,37,22,15,0.5945945945945946,0.40540540540540543
500,-0.26076210737228395,0.495008643879898,5,2,3,0.4,0.6
501,0.276098189600667,0.6081254930340434,61,40,21,0.6557377049180327,0.3442622950819672
502,0.21668335597496483,0.5894276016437945,8,5,3,0.625,0.375
503,-0.3483358159661293,0.31919561849712713,5,1,4,0.2,0.8
504,0.12275336058958185,0.6108895460411395,63,40,23,0.6349206349206349,0.36507936507936506
505,0.4879502762729923,0.5328708876544348,21,17,4,0.8095238095238095,0.19047619047619047
506,0.05018170053760212,0.5475204113285945,15,7,8,0.4666666666666667,0.5333333333333333
507,0.26261091971879497,0.49126528622467186,34,22,12,0.6470588235294118,0.35294117647058826
508,-0.6026476073078811,0.4920177818143903,10,1,9,0.1,0.9
509,0.23854195658350366,0.5482029716404743,16,10,6,0.625,0.375
510,-0.5462469869914154,0.6485658831808369,6,1,5,0.16666666666666666,0.8333333333333334
511,0.2648453843469421,0.5720582267128517,90,60,30,0.6666666666666666,0.3333333333333333
512,0.37080891082534595,0.5071713007372946,83,62,21,0.7469879518072289,0.25301204819277107
513,-0.24165160356856444,0.6316748198178359,51,17,34,0.3333333333333333,0.6666666666666666
514,-0.0805021536193396,0.6644772659448862,19,8,11,0.42105263157894735,0.5789473684210527
515,-0.11537832077592611,0.5807914823154479,80,30,50,0.375,0.625
516,0.13901824494502668,0.735051506848621,58,35,23,0.603448275862069,0.39655172413793105
517,-0.3556361473925716,0.6010520999660288,49,14,35,0.2857142857142857,0.7142857142857143
518,0.12661015922920063,0.6245265837454457,26,15,11,0.5769230769230769,0.4230769230769231
519,0.13348287507891654,0.49487278438614024,75,46,29,0.6133333333333333,0.38666666666666666
520,-0.2243599313000838,0.6575584741923665,15,5,10,0.3333333333333333,0.6666666666666666
521,0.18610194232314828,0.5730175908926398,42,26,16,0.6190476190476191,0.38095238095238093
522,0.179824181992946,0.6265997286186735,29,16,13,0.5517241379310345,0.4482758620689655
523,0.0809205934787408,0.6726426288036855,39,24,15,0.6153846153846154,0.38461538461538464
524,-0.8161169476807117,0.08246930219536515,2,0,2,0.0,1.0
525,0.438949314835058,0.5180455766720283,110,87,23,0.7909090909090909,0.20909090909090908
526,0.3808452067212365,0.48529904237209864,313,233,80,0.744408945686901,0.25559105431309903
527,0.1365707458462566,0.5326324358835921,20,14,6,0.7,0.3
528,0.5028944801279279,0.4968756557396168,43,35,8,0.813953488372093,0.18604651162790697
530,-0.4133819341659546,0.30813295421169007,2,0,2,0.0,1.0
531,0.27487500099351214,0.5557339610802561,98,68,30,0.6938775510204082,0.30612244897959184
532,-0.09291479950770735,0.6191618827789253,20,8,12,0.4,0.6
533,-0.09175096445583872,0.517532202406035,28,13,15,0.4642857142857143,0.5357142857142857
534,-0.601966592669487,0.17833057586742032,5,0,5,0.0,1.0
535,-0.4264218927171357,0.528351651177787,108,20,88,0.18518518518518517,0.8148148148148148
536,-0.1155082310239474,0.3639986174317655,6,2,4,0.3333333333333333,0.6666666666666666
537,-0.1532145635811267,0.5973594657122744,27,10,17,0.37037037037037035,0.6296296296296297
538,0.15137697714541493,0.592105834093388,58,37,21,0.6379310344827587,0.3620689655172414
539,-0.08216544197729,0.6790596948671106,26,12,14,0.46153846153846156,0.5384615384615384
540,0.08310386871821002,0.6412187865692192,19,12,7,0.631578947368421,0.3684210526315789
541,0.4110158770603852,0.5731498351949122,126,94,32,0.746031746031746,0.25396825396825395
542,0.40714689876352045,0.735912907678245,7,5,2,0.7142857142857143,0.2857142857142857
543,0.3710815166588873,0.5584513780103656,80,57,23,0.7125,0.2875
544,0.1981986900543173,0.5845553980075733,150,87,63,0.58,0.42
545,0.2500037668574163,0.6173160927065129,68,44,24,0.6470588235294118,0.35294117647058826
546,-0.17282226350572374,0.7461372768519763,9,4,5,0.4444444444444444,0.5555555555555556
547,-0.04500185219981409,0.6389643300361318,59,27,32,0.4576271186440678,0.5423728813559322
548,-0.45719479189978707,0.31071138046622343,9,1,8,0.1111111111111111,0.8888888888888888
549,0.10166400357742202,0.6158842271129394,22,11,11,0.5,0.5
550,0.09780514413224799,0.7355948007104763,28,15,13,0.5357142857142857,0.4642857142857143
551,0.1916884091742178,0.5793371774275687,94,55,39,0.5851063829787234,0.4148936170212766
552,0.4149977557361126,0.5018437344895194,10,8,2,0.8,0.2
553,-0.1642393150752218,0.6888057817407935,58,20,38,0.3448275862068966,0.6551724137931034
554,0.12916714952486316,0.429395421485502,41,20,21,0.4878048780487805,0.5121951219512195
555,-0.03238638518660358,0.6406024409276522,33,17,16,0.5151515151515151,0.48484848484848486
556,-0.03721450096262354,0.5230484846856307,84,33,51,0.39285714285714285,0.6071428571428571
557,-0.4273456549271941,0.48692001231933496,20,3,17,0.15,0.85
558,0.15164515587190788,0.4867275972753029,45,23,22,0.5111111111111111,0.4888888888888889
559,-0.011742674206432532,0.6676979917509532,38,19,19,0.5,0.5
560,0.20936961065639154,0.564944601506544,11,7,4,0.6363636363636364,0.36363636363636365
561,0.18364510472331733,0.5316779643612107,7,5,2,0.7142857142857143,0.2857142857142857
562,0.34724850791760464,0.6113556759046067,44,33,11,0.75,0.25
563,0.02669916564568143,0.6822345159247905,61,33,28,0.5409836065573771,0.45901639344262296
564,0.15612352182003988,0.5254551173971967,249,143,106,0.5742971887550201,0.42570281124497994
565,0.019252227509723007,0.5559411803252409,17,10,7,0.5882352941176471,0.4117647058823529
566,0.37293877880682613,0.53670343697974,1048,788,260,0.7519083969465649,0.2480916030534351
567,-0.026760984574341107,0.590641336167021,36,16,20,0.4444444444444444,0.5555555555555556
568,0.3255949318408966,0.5692419773044415,20,15,5,0.75,0.25
569,-0.35929327972233294,0.6241699421199934,25,6,19,0.24,0.76
570,0.1371822427544329,0.507588632674491,18,11,7,0.6111111111111112,0.3888888888888889
571,0.16750041293630075,0.531174199892345,86,48,38,0.5581395348837209,0.4418604651162791
572,0.11101463981286948,0.5285884352580171,83,52,31,0.6265060240963856,0.37349397590361444
573,-0.028061154044487228,0.7338366534492108,11,7,4,0.6363636363636364,0.36363636363636365
574,-0.20672763528332846,0.6722771246453237,61,22,39,0.36065573770491804,0.639344262295082
575,0.06873540083567302,0.691042630446764,3,2,1,0.6666666666666666,0.3333333333333333
576,0.12451102025806907,0.6027756888587461,30,19,11,0.6333333333333333,0.36666666666666664
577,-0.034185930493880405,0.7000308376009149,33,17,16,0.5151515151515151,0.48484848484848486
578,0.11653337143606653,0.5321530787036928,76,45,31,0.5921052631578947,0.40789473684210525
579,0.08759207444979925,0.5844137231499348,146,72,74,0.4931506849315068,0.5068493150684932
580,0.0256655233794115,0.5738032055594751,71,34,37,0.4788732394366197,0.5211267605633803
581,-0.031000745586223073,0.5026259344282873,18,6,12,0.3333333333333333,0.6666666666666666
582,0.5651350326836109,0.38735097063956164,5,5,0,1.0,0.0
583,0.08530966619796612,0.5429832085542182,34,13,21,0.38235294117647056,0.6176470588235294
584,0.13580462810668079,0.6489164801061997,11,6,5,0.5454545454545454,0.45454545454545453
585,-0.49779788878830994,0.42594332537482726,11,3,8,0.2727272727272727,0.7272727272727273
586,-0.5983022708445788,0.44662350725160516,25,2,23,0.08,0.92
587,0.8374619334936141,,1,1,0,1.0,0.0
588,-0.013984247551409793,0.6141206696511589,186,88,98,0.4731182795698925,0.5268817204301075
589,0.18539111031434283,0.6279800975322123,52,35,17,0.6730769230769231,0.3269230769230769
590,0.17816851248678106,0.8022348467674648,26,16,10,0.6153846153846154,0.38461538461538464
591,0.08582470729015766,0.4969726426749421,16,9,7,0.5625,0.4375
592,0.10480764639135956,0.6527448715142206,37,19,18,0.5135135135135135,0.4864864864864865
593,0.03538318300763002,0.5817510156744048,52,25,27,0.4807692307692308,0.5192307692307693
594,-0.2503241843989362,0.6559657923797753,23,8,15,0.34782608695652173,0.6521739130434783
595,0.07755670528142497,0.40303518848808134,26,14,12,0.5384615384615384,0.46153846153846156
596,0.1575349178530422,0.5267256801701241,51,28,23,0.5490196078431373,0.45098039215686275
597,0.34036665479652584,0.583944873863685,56,38,18,0.6785714285714286,0.32142857142857145
598,-0.4554623846585552,0.5135529860871447,12,2,10,0.16666666666666666,0.8333333333333334
599,-0.1221206399079944,0.7131430651947533,14,7,7,0.5,0.5
600,0.5349388196516562,0.4349050512577845,17,15,2,0.8823529411764706,0.11764705882352941
601,-0.06999748939162363,0.5829246728317096,46,22,24,0.4782608695652174,0.5217391304347826
602,-0.08734526077196711,0.6057594252867957,21,9,12,0.42857142857142855,0.5714285714285714
603,0.23936091739922127,0.5599631530975611,47,31,16,0.6595744680851063,0.3404255319148936
604,0.2771178980315612,0.5837194493497582,44,29,15,0.6590909090909091,0.3409090909090909
605,0.17459791012108325,0.5498439762451444,50,31,19,0.62,0.38
606,-0.10062163695693015,0.41117697359402533,8,4,4,0.5,0.5
607,0.2002875460893847,0.5702490714325592,16,8,8,0.5,0.5
608,0.16676502190530304,0.6546999620524385,10,6,4,0.6,0.4
609,-0.11715128604107752,0.6471080716164889,260,110,150,0.4230769230769231,0.5769230769230769
610,-0.25709344321133004,0.513091502885518,46,11,35,0.2391304347826087,0.7608695652173914
611,0.18958440303270305,0.5478399564080474,21,15,6,0.7142857142857143,0.2857142857142857
612,-0.5426446348428726,0.2924227375026786,2,0,2,0.0,1.0
613,0.7957152090966704,0.23138301096938965,2,2,0,1.0,0.0
614,0.06541316809930971,0.6612666991956031,28,17,11,0.6071428571428571,0.39285714285714285
615,0.2477714754901566,0.5372585700961343,286,193,93,0.6748251748251748,0.32517482517482516
616,-0.05888117803260689,0.6020895179660876,6,3,3,0.5,0.5
617,0.37235004603862765,0.537372806668073,5,4,1,0.8,0.2
618,0.2614957189070992,0.4612593418485677,32,23,9,0.71875,0.28125
619,0.2433464308096855,0.6031937429580758,27,18,9,0.6666666666666666,0.3333333333333333
620,0.23959081186771844,0.533537334484331,66,42,24,0.6363636363636364,0.36363636363636365
621,0.20398750640451915,0.7115067931793383,15,10,5,0.6666666666666666,0.3333333333333333
622,-0.10604375874266979,0.536361413318862,47,16,31,0.3404255319148936,0.6595744680851063
623,0.27858169931100635,0.44872103708082267,41,31,10,0.7560975609756098,0.24390243902439024
624,-0.16304436184111096,0.674376570602472,21,7,14,0.3333333333333333,0.6666666666666666
625,-0.01965223153432209,0.43311143098048194,15,9,6,0.6,0.4
626,0.21383238936725416,0.538763312454845,19,11,8,0.5789473684210527,0.42105263157894735
627,0.2999583557953663,0.6009184010760317,66,45,21,0.6818181818181818,0.3181818181818182
628,-0.200080759357661,0.620128454735486,8,4,4,0.5,0.5
629,0.11354797686739214,0.5294697877256612,58,28,30,0.4827586206896552,0.5172413793103449
630,0.5931314533310277,0.3807530750207928,7,6,1,0.8571428571428571,0.14285714285714285
631,0.2824712282046676,0.6262093684130601,25,18,7,0.72,0.28
632,-0.21790542732924226,0.47740902453508927,16,4,12,0.25,0.75
633,0.10170219854141276,0.461607289879621,24,16,8,0.6666666666666666,0.3333333333333333
634,-0.33396646436303856,0.5969819031995959,10,3,7,0.3,0.7
635,-0.2221247734207856,0.4355845795437994,19,5,14,0.2631578947368421,0.7368421052631579
636,-0.13731424139390133,0.599423164528985,194,72,122,0.3711340206185567,0.6288659793814433
637,0.49811853544444457,0.3966653926112287,49,43,6,0.8775510204081632,0.12244897959183673
638,-0.027042254805564908,0.5004913128844958,4,1,3,0.25,0.75
639,-0.19138870331355268,0.640896949419815,18,5,13,0.2777777777777778,0.7222222222222222
640,-0.18689806573092935,0.7120586501492279,8,3,5,0.375,0.625
641,-0.26531058922410017,0.8027547978576114,3,1,2,0.3333333333333333,0.6666666666666666
642,0.21892865463381725,0.5946284000272545,21,13,8,0.6190476190476191,0.38095238095238093
643,0.40795824140766446,0.5341122153822804,98,74,24,0.7551020408163265,0.24489795918367346
644,-0.02598474614322187,0.6768137099371208,25,13,12,0.52,0.48
645,-0.02762337014275163,0.5499492608959307,38,20,18,0.5263157894736842,0.47368421052631576
646,0.2599571836976016,0.47775251140593394,41,26,15,0.6341463414634146,0.36585365853658536
647,0.02569695242813652,0.6565289410765676,7,4,3,0.5714285714285714,0.42857142857142855
648,-0.21878879923712125,0.41975168062286733,11,3,8,0.2727272727272727,0.7272727272727273
649,0.29403460868879366,0.48301235896135114,19,13,6,0.6842105263157895,0.3157894736842105
650,-0.0689869196642013,0.6180458179041153,21,8,13,0.38095238095238093,0.6190476190476191
651,0.3585750550497323,0.5305985184287932,40,29,11,0.725,0.275
652,0.34638219722546637,0.6239277907555475,16,11,5,0.6875,0.3125
653,-0.2685337514665566,0.5018745924842571,19,6,13,0.3157894736842105,0.6842105263157895
654,-0.032332767522142786,0.6029969170690727,31,11,20,0.3548387096774194,0.6451612903225806
655,0.12376179533700146,0.7157748543475161,15,9,6,0.6,0.4
656,-0.12625391843418282,0.6573425033739798,6,3,3,0.5,0.5
657,-0.04781208898533476,0.4666423656399331,11,4,7,0.36363636363636365,0.6363636363636364
658,0.2414836470658581,0.6845009849068916,9,5,4,0.5555555555555556,0.4444444444444444
659,0.3375186052483817,0.44428239297707695,24,17,7,0.7083333333333334,0.2916666666666667
660,-0.2897369362413883,0.7643351280678328,5,2,3,0.4,0.6
661,0.17505978570973618,0.5018070153061203,47,29,18,0.6170212765957447,0.3829787234042553
662,-0.3327210175876434,0.5542219866892629,13,4,9,0.3076923076923077,0.6923076923076923
663,0.15813670307397842,0.46540150869406044,20,14,6,0.7,0.3
664,-0.33544311638582847,0.44315598142579,11,3,8,0.2727272727272727,0.7272727272727273
665,0.19019316575383838,0.5326785735014072,79,51,28,0.6455696202531646,0.35443037974683544
666,0.31196634885337615,0.4736934641611042,9,6,3,0.6666666666666666,0.3333333333333333
667,-0.023688484469185714,0.580504247219992,46,19,27,0.41304347826086957,0.5869565217391305
668,-0.7567556798458099,0.002771147536603552,3,0,3,0.0,1.0
669,-0.40418468435343946,0.5879415586744497,19,3,16,0.15789473684210525,0.8421052631578947
670,-0.24940529279410836,0.6036298543565016,4,2,2,0.5,0.5
671,-0.07816540874296524,0.5931920121916143,61,31,30,0.5081967213114754,0.4918032786885246
672,-0.07749097755403964,0.648117228566021,91,39,52,0.42857142857142855,0.5714285714285714
673,0.16756537442995334,0.601441676429991,59,34,25,0.576271186440678,0.423728813559322
674,0.036795609763690375,0.6006602364622613,7,4,3,0.5714285714285714,0.42857142857142855
675,-0.005096488166600473,0.6864614792466404,16,6,10,0.375,0.625
676,-0.21866893996907907,0.5424538498738398,11,4,7,0.36363636363636365,0.6363636363636364
677,0.07596882991492751,0.9559560916576271,5,3,2,0.6,0.4
678,0.11733867406197217,0.6978785907482415,23,14,9,0.6086956521739131,0.391304347826087
679,-0.11136112548410892,0.38952336946090266,8,2,6,0.25,0.75
680,-0.09325648912539086,0.640441267416132,75,30,45,0.4,0.6
681,-0.18501720055937765,0.6803395512184008,10,4,6,0.4,0.6
682,0.004992246627807617,,1,1,0,1.0,0.0
683,0.32287766101459664,0.6069227579984514,6,4,2,0.6666666666666666,0.3333333333333333
684,0.09051575925615099,0.6071942814188903,18,9,9,0.5,0.5
685,0.19943632202089898,0.682704480790818,28,19,9,0.6785714285714286,0.32142857142857145
686,0.22448582724771565,0.566484537411159,36,22,14,0.6111111111111112,0.3888888888888889
687,-0.62801295882673,0.3914751575413677,16,2,14,0.125,0.875
688,0.09729818671941758,0.43547739384721934,25,13,12,0.52,0.48
689,0.33358985604718333,0.5291233672340959,6,4,2,0.6666666666666666,0.3333333333333333
690,0.38935694949967525,0.6663487677894897,7,6,1,0.8571428571428571,0.14285714285714285
691,0.6320994198322296,,1,1,0,1.0,0.0
692,0.2328295380409275,0.5561435755675141,14,9,5,0.6428571428571429,0.35714285714285715
693,0.2917252501679791,0.46631940092078206,9,6,3,0.6666666666666666,0.3333333333333333
694,0.17681367648765445,0.5430901229983612,6,3,3,0.5,0.5
695,0.1140936552029517,0.4715676636360857,18,10,8,0.5555555555555556,0.4444444444444444
696,0.45889307698234916,0.43961459612608467,20,17,3,0.85,0.15
697,-0.07631108965724706,0.6905153145002398,15,6,9,0.4,0.6
698,0.21303868075103863,0.5691221466507586,46,28,18,0.6086956521739131,0.391304347826087
699,-0.30408865213394165,0.07458382176815127,2,0,2,0.0,1.0
700,-0.28577596303075553,0.692389963574163,5,2,3,0.4,0.6
701,-0.48046380479354417,0.576735690232448,44,10,34,0.22727272727272727,0.7727272727272727
702,0.2427293136715889,0.7019179670465985,4,2,2,0.5,0.5
703,-0.43608323733011883,0.28556595856235234,6,1,5,0.16666666666666666,0.8333333333333334
704,0.2749380450695753,0.5279333604523687,21,15,6,0.7142857142857143,0.2857142857142857
705,-0.2885485942242667,0.4244174198840938,32,5,27,0.15625,0.84375
706,0.14049555510282516,0.739663449334199,5,3,2,0.6,0.4
707,0.2931447071688516,0.5730029859447984,7,5,2,0.7142857142857143,0.2857142857142857
708,0.432249055399249,0.5038117614675195,12,9,3,0.75,0.25
709,-0.3496387799580892,0.6397383416515282,3,1,2,0.3333333333333333,0.6666666666666666
710,-0.3503927281842782,0.5489043648118976,13,4,9,0.3076923076923077,0.6923076923076923
711,0.03005339844605407,0.4086941704015614,37,23,14,0.6216216216216216,0.3783783783783784
712,-0.4878522649407387,0.8125691896526149,5,1,4,0.2,0.8
713,0.05101245641708377,0.06508122471549102,2,2,0,1.0,0.0
714,-0.2775771456460158,0.5643651521389947,6,2,4,0.3333333333333333,0.6666666666666666
715,-0.08689223341643809,0.6488225962851867,10,4,6,0.4,0.6
716,-0.2728028943658703,0.6397186627233473,27,10,17,0.37037037037037035,0.6296296296296297
717,0.09058741107583046,0.6229115829270712,5,4,1,0.8,0.2
718,0.4908503189476,0.4689108607220677,36,28,8,0.7777777777777778,0.2222222222222222
719,0.03765256376937031,0.7337921096359674,12,7,5,0.5833333333333334,0.4166666666666667
720,-0.2905721565087636,0.03605522763025857,3,0,3,0.0,1.0
721,-0.11443557889889115,0.6783770744725108,23,9,14,0.391304347826087,0.6086956521739131
722,-0.3962379325077766,0.693031489444938,18,5,13,0.2777777777777778,0.7222222222222222
723,0.22971246701975664,0.4951200945656111,12,8,4,0.6666666666666666,0.3333333333333333
724,0.37899579604466754,0.3306295242586041,3,3,0,1.0,0.0
725,0.15248512849211693,0.6069562262168298,16,9,7,0.5625,0.4375
726,-0.05261882394552227,0.6252184588635282,5,3,2,0.6,0.4
727,0.571879655122757,0.18250226037314476,2,2,0,1.0,0.0
728,-0.2838116695897447,0.7465765793274434,9,2,7,0.2222222222222222,0.7777777777777778
729,0.03149085491895678,0.6605454060765444,7,4,3,0.5714285714285714,0.42857142857142855
730,0.09667627587914474,0.8529807052758197,5,3,2,0.6,0.4
731,0.03517661931423041,0.4626813774572493,13,7,6,0.5384615384615384,0.46153846153846156
732,0.21184254166754812,0.7213728842121082,11,7,4,0.6363636363636364,0.36363636363636365
733,-0.04081514191169007,0.36702860761361294,26,6,20,0.23076923076923078,0.7692307692307693
734,0.031662602705182535,0.6840934791443767,32,16,16,0.5,0.5
735,-0.481195179396309,0.5812276044188038,8,2,6,0.25,0.75
736,0.14764525999243444,0.5523202812243457,26,16,10,0.6153846153846154,0.38461538461538464
737,-0.09832069597073965,0.6884876117227492,14,7,7,0.5,0.5
738,-0.059454128146171625,1.238908013360443,2,1,1,0.5,0.5
739,0.5267854721047157,0.5567251564701085,43,35,8,0.813953488372093,0.18604651162790697
740,-0.17816752195358276,0.32538028755931825,2,1,1,0.5,0.5
741,0.18043125402182342,0.4811846983912044,20,14,6,0.7,0.3
742,-0.7898882441222668,0.1893389796954379,2,0,2,0.0,1.0
743,-0.13050316274166107,0.19162142647147717,2,1,1,0.5,0.5
744,-0.23657688048357764,0.6667613922812105,12,5,7,0.4166666666666667,0.5833333333333334
745,0.24716921587541854,0.548231248147671,97,68,29,0.7010309278350515,0.29896907216494845
746,0.044300256180576966,0.6112312439628148,8,4,4,0.5,0.5
747,-0.20078860567365256,0.54962440603286,36,12,24,0.3333333333333333,0.6666666666666666
748,0.13878001583119234,0.5270933744188434,54,28,26,0.5185185185185185,0.48148148148148145
749,-0.22682636976242065,0.44214417345719975,25,8,17,0.32,0.68
750,-0.3893964931901012,0.6355911928422765,7,1,6,0.14285714285714285,0.8571428571428571
751,0.14151241881056478,0.5376247181112431,26,16,10,0.6153846153846154,0.38461538461538464
752,0.4629928119676678,0.5031055781480518,19,16,3,0.8421052631578947,0.15789473684210525
753,0.15549870718408515,0.5521320983305058,27,14,13,0.5185185185185185,0.48148148148148145
754,-0.17291076729695,0.6961379964186679,6,2,4,0.3333333333333333,0.6666666666666666
755,0.14217889737337827,0.6585879400898751,20,13,7,0.65,0.35
756,0.12303385923483541,0.5445902007150927,28,15,13,0.5357142857142857,0.4642857142857143
757,0.21980269812047482,0.6070463863061647,6,3,3,0.5,0.5
758,0.0976274367421866,0.8179108666194443,6,3,3,0.5,0.5
759,0.16702258680015802,0.5413752555062464,16,10,6,0.625,0.375
760,-0.02953780970225732,0.7341420804962414,24,11,13,0.4583333333333333,0.5416666666666666
761,0.08252164721488957,0.505640088599406,4,2,2,0.5,0.5
762,0.38256679481414496,0.5002461324735702,61,49,12,0.8032786885245902,0.19672131147540983
763,0.027008324395865216,0.7243933570579585,8,5,3,0.625,0.375
764,0.506707434852918,0.31986497814762627,3,3,0,1.0,0.0
765,0.24317997694015503,0.6328140458860736,10,6,4,0.6,0.4
766,0.9729528315365314,,1,1,0,1.0,0.0
767,0.011885659303516038,1.3712976596588784,2,1,1,0.5,0.5
768,-0.05600243753620556,0.7867460845487471,7,3,4,0.42857142857142855,0.5714285714285714
769,0.08884876418639634,0.6712006539246721,17,8,9,0.47058823529411764,0.5294117647058824
770,-0.09828808034459752,0.5169524851961245,6,2,4,0.3333333333333333,0.6666666666666666
771,0.19242577148335321,0.6147783832187769,7,4,3,0.5714285714285714,0.42857142857142855
772,-0.2560774939134717,0.7353408045441381,5,2,3,0.4,0.6
773,0.18286761531123408,0.6147308565343651,27,16,11,0.5925925925925926,0.4074074074074074
774,0.8209605664014816,,1,1,0,1.0,0.0
775,0.022536906475822124,0.6800940036287726,15,7,8,0.4666666666666667,0.5333333333333333
776,0.3754787892103195,0.40682605144804507,4,3,1,0.75,0.25
777,-0.5062120702117683,0.7208353599102991,5,1,4,0.2,0.8
778,0.2666121187309424,0.5022917522410149,6,4,2,0.6666666666666666,0.3333333333333333
779,0.29206137806177146,0.7243377336038671,5,4,1,0.8,0.2
780,-0.016344685107469552,0.6026582777084114,7,5,2,0.7142857142857143,0.2857142857142857
781,0.19305584745274648,0.6180799533423937,9,6,3,0.6666666666666666,0.3333333333333333
782,-0.07111024530604482,0.5947829951143162,19,8,11,0.42105263157894735,0.5789473684210527
783,-0.31103955116122967,0.6682440177899822,4,1,3,0.25,0.75
784,0.18881167769432067,0.37110250844445236,5,3,2,0.6,0.4
785,-0.14260720820831402,0.5937765012156265,14,5,9,0.35714285714285715,0.6428571428571429
786,-0.31724974513053894,0.25691989711761765,2,0,2,0.0,1.0
787,0.1697780321817845,0.6177679635548522,20,12,8,0.6,0.4
788,0.06459722833500971,0.6134781674523438,9,5,4,0.5555555555555556,0.4444444444444444
789,0.876793351645271,0.061106536625826866,3,3,0,1.0,0.0
790,-0.3379978239536286,,1,0,1,0.0,1.0
791,0.2072608768939972,0.37636644866809604,6,4,2,0.6666666666666666,0.3333333333333333
792,0.5039594130357727,0.4765996110126607,16,14,2,0.875,0.125
793,0.10636478265126548,0.5309632532456273,15,9,6,0.6,0.4
794,0.17043606243256865,0.5265993979348099,29,16,13,0.5517241379310345,0.4482758620689655
795,0.028817924515654608,0.6642270991700606,6,3,3,0.5,0.5
796,-0.0810306338327272,0.6483501170576357,7,3,4,0.42857142857142855,0.5714285714285714
797,-0.06799649354070424,0.6721283319441433,12,7,5,0.5833333333333334,0.4166666666666667
798,0.3060057588985988,0.6534365017190907,14,10,4,0.7142857142857143,0.2857142857142857
799,0.2982088838304792,0.5235093920454034,7,5,2,0.7142857142857143,0.2857142857142857
800,-0.4402376494836062,0.45236633385173086,8,2,6,0.25,0.75
801,0.29835662618279457,0.74088916623163,6,4,2,0.6666666666666666,0.3333333333333333
802,0.41474197879433633,0.5427097194174757,5,4,1,0.8,0.2
803,0.4416395630687476,0.530394472951416,4,3,1,0.75,0.25
804,0.058622493126401394,0.589067371989314,66,33,33,0.5,0.5
805,0.20048173197678157,0.5063206534762378,7,4,3,0.5714285714285714,0.42857142857142855
806,0.3481362246804768,0.5330135442782516,9,6,3,0.6666666666666666,0.3333333333333333
809,0.6076731582482656,0.026505254669898424,3,3,0,1.0,0.0
810,0.1958066659669082,0.6849913855230132,3,2,1,0.6666666666666666,0.3333333333333333
811,-0.0508382588624954,0.7852037970682457,5,2,3,0.4,0.6
812,0.3948349489697388,0.5576013908361144,7,5,2,0.7142857142857143,0.2857142857142857
813,-0.2513500154018402,,1,0,1,0.0,1.0
814,-0.18910309821367263,0.6821981862463141,5,2,3,0.4,0.6
815,0.3011970782859458,0.4304040383811517,18,14,4,0.7777777777777778,0.2222222222222222
816,0.3920783059568041,0.6433067581702168,108,78,30,0.7222222222222222,0.2777777777777778
817,-0.22389366334447494,0.5923141272909199,13,5,8,0.38461538461538464,0.6153846153846154
818,0.7949247956275941,,1,1,0,1.0,0.0
819,0.04474890035473636,0.7229814829337192,9,5,4,0.5555555555555556,0.4444444444444444
820,0.47224406735040253,0.504690407156925,12,10,2,0.8333333333333334,0.16666666666666666
821,0.7579294443130493,,1,1,0,1.0,0.0
822,-0.026075666615118603,0.6978761539102668,6,3,3,0.5,0.5
823,0.12730357583080018,0.5994733789938727,21,14,7,0.6666666666666666,0.3333333333333333
824,0.0035898685455322543,0.48153562569763586,2,1,1,0.5,0.5
825,0.3951419424265623,0.5046866847715994,8,6,2,0.75,0.25
826,0.3227683965508875,0.6017280702011144,19,14,5,0.7368421052631579,0.2631578947368421
827,-0.08500972999767822,0.7347247016005648,11,5,6,0.45454545454545453,0.5454545454545454
828,-0.16692619025707242,0.24312976438621697,2,1,1,0.5,0.5
829,-0.013972099870443329,0.8204921467643035,7,3,4,0.42857142857142855,0.5714285714285714
830,0.009411410273363155,0.814084972045637,6,3,3,0.5,0.5
831,0.41278516920283437,0.3960732953831254,16,13,3,0.8125,0.1875
832,-0.5146455155419452,0.5319506279700296,7,1,6,0.14285714285714285,0.8571428571428571
833,-0.3718704357743263,0.5329662975072822,2,1,1,0.5,0.5
834,-0.653532650321722,0.3956180053343671,2,0,2,0.0,1.0
835,0.12265724875032902,0.4973528747969079,8,4,4,0.5,0.5
836,-0.017956978486229958,0.5970950855597833,12,6,6,0.5,0.5
837,0.19573685862854415,0.4931864180281317,51,34,17,0.6666666666666666,0.3333333333333333
838,0.2041035262601716,0.4547896983907786,7,5,2,0.7142857142857143,0.2857142857142857
839,0.39251516440085005,0.42794423360290534,7,6,1,0.8571428571428571,0.14285714285714285
841,0.18256288766860956,0.9901048511594626,2,1,1,0.5,0.5
842,0.1085268408060074,0.6281047894127304,11,7,4,0.6363636363636364,0.36363636363636365
843,-0.07044251381673595,0.5641867453444147,11,6,5,0.5454545454545454,0.45454545454545453
844,-0.5486228112131357,0.5558061198914231,2,0,2,0.0,1.0
845,0.15037268089751407,0.6614514264086374,12,5,7,0.4166666666666667,0.5833333333333334
846,-0.46414795517921453,0.21428214986475447,3,0,3,0.0,1.0
847,-0.23034121692180634,0.5647961868189226,5,1,4,0.2,0.8
848,0.5582147926092148,0.15615558258614484,5,5,0,1.0,0.0
849,0.09769154026483497,0.5335345230797771,30,17,13,0.5666666666666667,0.43333333333333335
850,0.0709630583243614,0.581579772770085,22,12,10,0.5454545454545454,0.45454545454545453
851,-0.06702480216821038,0.7089101381365182,3,2,1,0.6666666666666666,0.3333333333333333
852,0.5084339566528797,0.5330372464583941,2,2,0,1.0,0.0
854,0.32643596579631173,0.48905672066696737,6,5,1,0.8333333333333334,0.16666666666666666
856,0.5200876038100931,0.4261206669859566,31,28,3,0.9032258064516129,0.0967741935483871
857,0.23895428702235222,0.3310649353486583,8,5,3,0.625,0.375
858,-0.3071287421626039,0.4745723674119772,16,5,11,0.3125,0.6875
859,0.1103456177127858,0.6074511472623011,108,62,46,0.5740740740740741,0.42592592592592593
860,-0.4145571325312961,0.3349412963758988,11,1,10,0.09090909090909091,0.9090909090909091
861,-0.1261185691691935,0.5967294689604951,12,5,7,0.4166666666666667,0.5833333333333334
862,0.1353596954916915,0.7862156154495322,3,2,1,0.6666666666666666,0.3333333333333333
863,0.2192389733261532,0.554706209794295,9,6,3,0.6666666666666666,0.3333333333333333
864,-0.19003533482551574,0.4763483934777277,25,10,15,0.4,0.6
865,0.17269895101586977,0.6246157966099881,6,4,2,0.6666666666666666,0.3333333333333333
866,-0.16840004920959478,,1,0,1,0.0,1.0
867,-0.17025154787633157,0.47352569447667126,9,2,7,0.2222222222222222,0.7777777777777778
868,0.4611404705792665,0.6450903725618253,2,2,0,1.0,0.0
869,0.20857552376886213,0.48404764058079436,9,7,2,0.7777777777777778,0.2222222222222222
870,-0.1162419319152832,,1,0,1,0.0,1.0
871,-0.45443185716867446,0.42389637166816063,5,1,4,0.2,0.8
872,0.47747656556241447,0.551218596769824,33,25,8,0.7575757575757576,0.24242424242424243
873,0.7690242858869689,0.08101599244355587,7,7,0,1.0,0.0
874,-0.31062003118651255,0.6981944575688034,7,3,4,0.42857142857142855,0.5714285714285714
875,-0.5328686237335205,,1,0,1,0.0,1.0
876,-0.2718103049056871,0.5628668738224529,7,2,5,0.2857142857142857,0.7142857142857143
877,0.9721013717353345,,1,1,0,1.0,0.0
878,0.3733117814574923,0.5401292968598679,7,4,3,0.5714285714285714,0.42857142857142855
879,0.1687288855512937,0.5869536256193296,24,14,10,0.5833333333333334,0.4166666666666667
880,0.03740964680910114,0.4778240754736767,5,3,2,0.6,0.4
881,-0.022861881713782038,0.6561220330979983,14,7,7,0.5,0.5
882,0.43586951053955336,0.4542836325844714,22,18,4,0.8181818181818182,0.18181818181818182
883,0.7281391359865667,0.23786227760110573,2,2,0,1.0,0.0
884,0.7043553907424213,0.3220489611403466,2,2,0,1.0,0.0
885,-0.3898019152335249,0.4597085001318251,104,20,84,0.19230769230769232,0.8076923076923077
886,0.35033203909794497,0.55048297007559,9,5,4,0.5555555555555556,0.4444444444444444
887,0.32633276749402285,0.4694349044272621,8,5,3,0.625,0.375
888,0.004993081092834528,,1,1,0,1.0,0.0
889,0.2817958794767037,0.5743608220058698,64,47,17,0.734375,0.265625
890,-0.022915384173393227,0.5543371361670195,5,2,3,0.4,0.6
891,0.8377316258847715,0.045974651634433594,2,2,0,1.0,0.0
892,-0.023722858168184768,0.6179394700251447,10,4,6,0.4,0.6
893,0.14914972782135014,0.7407030729133293,5,3,2,0.6,0.4
895,0.0773510503797577,0.5267727231741214,26,15,11,0.5769230769230769,0.4230769230769231
896,-0.12807522527873516,0.5742902243496963,4,2,2,0.5,0.5
897,-0.7548067942261696,,1,0,1,0.0,1.0
898,0.24621153622865674,0.5682592676601832,2,1,1,0.5,0.5
899,-0.30493239909410474,0.7394620017658121,5,1,4,0.2,0.8
900,-0.09831741994077509,0.6697067708567308,11,7,4,0.6363636363636364,0.36363636363636365
901,0.11772892118564673,0.5249676992325405,14,5,9,0.35714285714285715,0.6428571428571429
902,0.16976162387679025,0.5926123087605614,12,9,3,0.75,0.25
903,-0.26393816620111465,0.3803254164788939,2,1,1,0.5,0.5
904,-0.039663869760591886,0.6063131541614125,22,11,11,0.5,0.5
905,-0.2134641818702221,0.5093774752178124,8,3,5,0.375,0.625
906,-0.6169873368926346,0.4268681249569226,4,1,3,0.25,0.75
907,-0.33573631114429897,0.4453620201178665,9,3,6,0.3333333333333333,0.6666666666666666
908,0.23538468405604362,0.4566327031362275,4,3,1,0.75,0.25
909,-0.5743530169129372,0.004268727647592497,2,0,2,0.0,1.0
910,0.7168961390852928,0.06446601770448968,2,2,0,1.0,0.0
911,0.07296410331932399,0.6598458311904123,26,13,13,0.5,0.5
912,0.15003011198487223,0.5328405646065205,41,23,18,0.5609756097560976,0.43902439024390244
913,-0.019498184323310835,0.5448011963466188,3,2,1,0.6666666666666666,0.3333333333333333
914,0.3307092098089365,0.47466366165011936,13,11,2,0.8461538461538461,0.15384615384615385
915,0.3507707073456711,0.5139572054353414,18,14,4,0.7777777777777778,0.2222222222222222
916,0.6616847440600395,0.13611110831337034,2,2,0,1.0,0.0
917,0.498193770647049,,1,1,0,1.0,0.0
918,-0.30400361493229866,0.300408196318618,4,1,3,0.25,0.75
919,-0.015967285526650277,0.6607285328417035,7,3,4,0.42857142857142855,0.5714285714285714
920,-0.4655459180474281,0.3053055460704186,5,1,4,0.2,0.8
921,-0.19268579532702765,0.3230098877369391,6,2,4,0.3333333333333333,0.6666666666666666
922,-0.26514206677675245,0.48013119669868787,5,2,3,0.4,0.6
923,0.17595647453951338,0.47636573997052606,48,32,16,0.6666666666666666,0.3333333333333333
924,0.12685944139957428,0.6504503934745584,7,4,3,0.5714285714285714,0.42857142857142855
926,0.31425635019938153,0.2860061957938656,9,8,1,0.8888888888888888,0.1111111111111111
927,0.005691767500882799,0.6965437051770044,11,5,6,0.45454545454545453,0.5454545454545454
928,0.22440866455435757,0.6504953407267599,5,4,1,0.8,0.2
929,-0.33923981189727787,0.6530488611014652,5,1,4,0.2,0.8
930,0.14546378024599768,0.6789081886378368,11,6,5,0.5454545454545454,0.45454545454545453
931,0.9462840911000967,,1,1,0,1.0,0.0
932,0.1744000736624003,0.7220004823122936,5,3,2,0.6,0.4
933,0.11729350743385464,0.5199823531400678,13,6,7,0.46153846153846156,0.5384615384615384
934,0.0757145881652832,,1,1,0,1.0,0.0
936,0.42869099952574624,0.6125275121739197,171,135,36,0.7894736842105263,0.21052631578947367
937,0.0008949886283112989,0.6092135739081229,36,16,20,0.4444444444444444,0.5555555555555556
938,0.1723577752709388,0.6516807992542034,3,1,2,0.3333333333333333,0.6666666666666666
939,0.19231434219649862,0.48706474879522843,14,9,5,0.6428571428571429,0.35714285714285715
940,-0.04724605679512025,0.4051329333442086,5,2,3,0.4,0.6
941,0.2709645740687847,0.47806660850155175,6,4,2,0.6666666666666666,0.3333333333333333
942,-0.41138751556475966,0.3891154836488128,3,0,3,0.0,1.0
943,0.21305658559625348,0.7443416773253947,12,7,5,0.5833333333333334,0.4166666666666667
944,0.4330039171708955,0.5015595786678059,45,36,9,0.8,0.2
945,-0.19143623561831194,0.6217042785412044,16,4,12,0.25,0.75
946,0.3676365953288041,0.6135940243983962,16,11,5,0.6875,0.3125
947,-0.020355422049760787,0.6073114387636329,7,4,3,0.5714285714285714,0.42857142857142855
949,0.8933839313685894,,1,1,0,1.0,0.0
950,-0.7285471111536026,,1,0,1,0.0,1.0
951,0.15816839300096036,0.783171177682656,10,6,4,0.6,0.4
952,0.35345177008555484,0.46050671113553715,13,10,3,0.7692307692307693,0.23076923076923078
953,-0.1174830071007212,0.4596222926759954,12,4,8,0.3333333333333333,0.6666666666666666
954,-0.07964624650776386,0.40739750308506334,8,3,5,0.375,0.625
955,0.5284615622626411,0.6480559701008927,9,8,1,0.8888888888888888,0.1111111111111111
956,-0.0676955073657963,0.652834056306807,9,3,6,0.3333333333333333,0.6666666666666666
957,0.2833920962044171,0.6873336297981057,7,4,3,0.5714285714285714,0.42857142857142855
959,0.3836613595485688,0.47914214186719273,3,3,0,1.0,0.0
961,-0.03636228044827777,0.19872035094935941,3,2,1,0.6666666666666666,0.3333333333333333
962,0.04347778028912014,0.43179047870044585,9,6,3,0.6666666666666666,0.3333333333333333
963,0.31024923859710307,0.5976656789221516,133,87,46,0.6541353383458647,0.3458646616541353
965,-0.9281985992565751,0.04012225747113354,2,0,2,0.0,1.0
966,-0.03590491414070127,0.2090051042011902,3,2,1,0.6666666666666666,0.3333333333333333
967,0.09056775138846465,0.5016791338176702,14,6,8,0.42857142857142855,0.5714285714285714
968,0.20603450015187263,0.801764243277263,4,2,2,0.5,0.5
970,0.21921351055304208,0.6212877703373381,6,5,1,0.8333333333333334,0.16666666666666666
971,0.2487667575478554,0.4938762009133703,7,5,2,0.7142857142857143,0.2857142857142857
972,-0.6540611088275909,,1,0,1,0.0,1.0
973,0.0031788228079676836,0.6349384529029222,8,4,4,0.5,0.5
974,-0.6420595645904541,,1,0,1,0.0,1.0
975,0.12850930435316904,0.4068798019295905,7,5,2,0.7142857142857143,0.2857142857142857
976,0.04500391008332372,0.5645981761922003,8,5,3,0.625,0.375
977,0.5298904776573182,0.3736612091164542,3,3,0,1.0,0.0
978,-0.08949562907218939,,1,0,1,0.0,1.0
979,0.13072833418846136,,1,1,0,1.0,0.0
980,0.08965281485801653,0.6206681687861302,21,13,8,0.6190476190476191,0.38095238095238093
981,-0.17296488583087924,0.1216637056645282,4,1,3,0.25,0.75
982,0.21878869272768497,0.5475740569414018,4,2,2,0.5,0.5
983,0.7097507677972317,0.06813539082447694,2,2,0,1.0,0.0
985,0.3148317097996672,0.624498490503689,6,5,1,0.8333333333333334,0.16666666666666666
986,0.6368029862642289,,1,1,0,1.0,0.0
987,0.32479401584714657,0.4305418484227154,4,3,1,0.75,0.25
988,-0.3317642151378095,0.4893534496308615,4,2,2,0.5,0.5
989,0.3055814591546853,0.6663774688827158,6,5,1,0.8333333333333334,0.16666666666666666
990,0.30936759254998636,0.5633307971197845,9,7,2,0.7777777777777778,0.2222222222222222
991,0.375090011395514,0.5470022126415136,12,9,3,0.75,0.25
992,-0.23313952554017306,0.6381290160431096,5,2,3,0.4,0.6
993,0.004993647336959839,,1,1,0,1.0,0.0
994,-0.2395436326041818,0.40714159655882665,8,1,7,0.125,0.875
995,-0.15213242452591655,0.9416274549077485,4,2,2,0.5,0.5
996,0.760621290653944,0.003806845603117673,2,2,0,1.0,0.0
997,-0.43689073870579404,0.27812517389215147,6,1,5,0.16666666666666666,0.8333333333333334
998,-0.16416232287883759,0.4998289682285735,6,1,5,0.16666666666666666,0.8333333333333334
999,0.08265514547626178,0.7675842515264175,12,7,5,0.5833333333333334,0.4166666666666667
1000,0.6754432767629623,,1,1,0,1.0,0.0
1001,0.8629895374178888,,1,1,0,1.0,0.0
1002,0.10098561892906825,0.612083275349836,6,4,2,0.6666666666666666,0.3333333333333333
1003,-0.16589456051588058,0.4318100425117445,4,2,2,0.5,0.5
1004,0.5588507317006588,0.42450111481697084,15,13,2,0.8666666666666667,0.13333333333333333
1005,0.19212599843740466,0.3598647057645698,6,4,2,0.6666666666666666,0.3333333333333333
1006,0.04830916039645675,0.637151125080922,6,3,3,0.5,0.5
1007,0.6386618576943874,0.33954721050722614,4,4,0,1.0,0.0
1008,0.5032841771220168,0.48364290180081093,3,3,0,1.0,0.0
1009,0.004992514848709162,,1,1,0,1.0,0.0
1010,0.11386259645223616,0.7971001344860094,3,2,1,0.6666666666666666,0.3333333333333333
1011,-0.016741447978549533,0.4855522053407124,9,4,5,0.4444444444444444,0.5555555555555556
1012,0.034753840416669846,0.7232998265193777,4,2,2,0.5,0.5
1013,0.44393276162445544,0.5211585631086282,5,4,1,0.8,0.2
1014,-0.15560844540596014,,1,0,1,0.0,1.0
1015,-0.28890073920289683,1.0101748877279593,3,1,2,0.3333333333333333,0.6666666666666666
1016,0.004972525872290079,1.333691506482117,2,1,1,0.5,0.5
1017,0.1101366753379504,0.6113295038621336,3,1,2,0.3333333333333333,0.6666666666666666
1018,-0.08693578715125716,0.6136020946591763,6,2,4,0.3333333333333333,0.6666666666666666
1020,-0.0964491789539655,0.4288089681741221,12,4,8,0.3333333333333333,0.6666666666666666
1021,0.232872606953606,0.5417022109206796,8,4,4,0.5,0.5
1022,-0.1322048207124074,0.12712171401428018,3,1,2,0.3333333333333333,0.6666666666666666
1023,-0.06612673588097095,0.524035139058541,6,2,4,0.3333333333333333,0.6666666666666666
1024,0.008025843783148693,0.6186029584204398,14,6,8,0.42857142857142855,0.5714285714285714
1025,0.18543753027915955,,1,1,0,1.0,0.0
1026,-0.21303595695644617,0.7134457384779554,10,4,6,0.4,0.6
1027,0.2964783161878586,0.41222283631822676,2,2,0,1.0,0.0
1028,0.22739428281784058,,1,1,0,1.0,0.0
1029,0.5367322294041514,0.49970691462311195,4,3,1,0.75,0.25
1030,0.5518627017736435,,1,1,0,1.0,0.0
1031,-0.8971722461283207,,1,0,1,0.0,1.0
1032,-0.024249696731567395,0.20032746130643703,5,3,2,0.6,0.4
1034,-0.8516764864325522,,1,0,1,0.0,1.0
1035,-0.9689367497339846,,1,0,1,0.0,1.0
1036,-0.10559283103793854,1.2212054611216718,2,1,1,0.5,0.5
1037,0.1172631718218326,1.0349889530886769,2,1,1,0.5,0.5
1038,0.5125356074422599,0.4696036072250558,4,3,1,0.75,0.25
1039,0.26464144906236065,0.6151528322709752,9,6,3,0.6666666666666666,0.3333333333333333
1040,0.25200738026095293,0.6991490210454593,7,4,3,0.5714285714285714,0.42857142857142855
1041,-0.23803846237640228,0.4564788028815217,31,8,23,0.25806451612903225,0.7419354838709677
1043,0.0049924552440643866,,1,1,0,1.0,0.0
1044,0.0049924552440643866,,1,1,0,1.0,0.0
1045,0.29459428042173386,0.49170666905888144,3,3,0,1.0,0.0
1046,0.0049924552440643866,,1,1,0,1.0,0.0
1047,-0.01712001363436381,0.6363532259142605,3,1,2,0.3333333333333333,0.6666666666666666
1048,-0.03558855503797533,0.7525926973783272,3,1,2,0.3333333333333333,0.6666666666666666
1050,-0.3204626142978668,,1,0,1,0.0,1.0
1051,0.29076824544204605,0.5669097528350197,9,7,2,0.7777777777777778,0.2222222222222222
1052,-0.0014563817530870715,0.6290398420718555,4,2,2,0.5,0.5
1053,-0.2549010713895162,0.5394908059450233,3,2,1,0.6666666666666666,0.3333333333333333
1054,-0.4387358203530311,0.5515388542126382,2,0,2,0.0,1.0
1055,0.3958338548739751,0.5883950711842739,3,2,1,0.6666666666666666,0.3333333333333333
1056,0.45489161647856236,0.5351833020541491,4,3,1,0.75,0.25
1058,0.13844582562645275,0.5865143206647057,12,7,5,0.5833333333333334,0.4166666666666667
1060,-0.9465289134532213,,1,0,1,0.0,1.0
1061,0.12363603586951888,0.586553214088564,6,3,3,0.5,0.5
1062,-0.3318687528371811,0.5559785837474915,5,1,4,0.2,0.8
1063,0.1415694698225707,0.8127262892917937,8,4,4,0.5,0.5
1064,0.40937094390392303,0.17504548465188458,3,3,0,1.0,0.0
1065,0.19168241772179803,0.6154327995335517,12,8,4,0.6666666666666666,0.3333333333333333
1066,0.004993647336959839,,1,1,0,1.0,0.0
1067,0.5510635864403512,0.20417514519538635,9,9,0,1.0,0.0
1069,-0.055576570332050323,1.0756221870973552,2,1,1,0.5,0.5
1070,0.45660279753307503,0.506648849655068,6,5,1,0.8333333333333334,0.16666666666666666
1071,0.4791921554133296,0.40558686836359714,8,6,2,0.75,0.25
1074,-0.18287295848131177,0.4550453182885277,6,3,3,0.5,0.5
1075,0.34044800549745563,0.560846608961258,5,4,1,0.8,0.2
1076,0.6759734377264977,0.12149350650515539,2,2,0,1.0,0.0
1078,-0.18045016378164294,0.31479977402735737,4,2,2,0.5,0.5
1079,0.7526274397969246,,1,1,0,1.0,0.0
1080,-0.028927815231409946,0.5842382303180562,11,5,6,0.45454545454545453,0.5454545454545454
1081,0.20198914706707,0.4834979134880248,5,4,1,0.8,0.2
1082,0.8879095390439034,,1,1,0,1.0,0.0
1083,-0.22945585846900943,0.4708616627261396,3,1,2,0.3333333333333333,0.6666666666666666
1084,-0.15306100249290472,,1,0,1,0.0,1.0
1085,-0.6501427888870239,0.22909117598284456,2,0,2,0.0,1.0
1086,0.4768850915133953,0.5245800601413534,4,3,1,0.75,0.25
1087,0.3161162808537483,0.6671195055832153,2,1,1,0.5,0.5
1088,0.25523393880575895,0.3830411443742261,8,6,2,0.75,0.25
1089,-0.16840040683746338,,1,0,1,0.0,1.0
1090,0.14356514811515808,0.9177967616803471,3,2,1,0.6666666666666666,0.3333333333333333
1091,-0.05019502341747284,0.7095891586502858,3,1,2,0.3333333333333333,0.6666666666666666
1092,0.6321037709712983,,1,1,0,1.0,0.0
1093,0.41870287060737615,,1,1,0,1.0,0.0
1094,0.30821414291858673,0.42581011864170737,5,3,2,0.6,0.4
1095,-0.6035719588398933,0.2138628628578756,6,0,6,0.0,1.0
1096,-0.22352597117424017,0.1242001426159119,9,0,9,0.0,1.0
1098,0.214556529903068,0.47608113979625793,13,9,4,0.6923076923076923,0.3076923076923077
1100,-0.8006919771432878,,1,0,1,0.0,1.0
1101,0.06024601869285105,0.7915069308150775,4,2,2,0.5,0.5
1102,-0.046001674607396126,0.6198864994723546,4,2,2,0.5,0.5
1103,-0.19352374970912936,0.0817786892040217,2,0,2,0.0,1.0
1104,0.6702626757323743,0.20253294525465215,2,2,0,1.0,0.0
1105,0.443129450082779,,1,1,0,1.0,0.0
1106,0.45656505227088934,,1,1,0,1.0,0.0
1107,0.6322485208511354,,1,1,0,1.0,0.0
1108,-0.3653142526745796,0.7054405581404877,4,1,3,0.25,0.75
1110,0.3692396329715848,0.47443685061062757,4,3,1,0.75,0.25
1111,-0.31119144707918167,0.4471532487435249,2,1,1,0.5,0.5
1112,0.4782636109739542,0.5930835549110334,10,8,2,0.8,0.2
1113,0.0049924552440643866,,1,1,0,1.0,0.0
1114,-0.02288746088743211,0.5161817464855744,6,3,3,0.5,0.5
1115,0.18999836081638935,0.8536363394711572,4,2,2,0.5,0.5
1116,-0.4872985780239105,0.4610659905155887,3,1,2,0.3333333333333333,0.6666666666666666
1117,0.12677042186260223,0.038227381260199186,2,2,0,1.0,0.0
1118,0.115436851978302,0.6569629970185491,3,2,1,0.6666666666666666,0.3333333333333333
1120,0.48842480809738237,0.6563302806684822,6,5,1,0.8333333333333334,0.16666666666666666
1121,0.049698488278822464,0.4562958185625677,11,4,7,0.36363636363636365,0.6363636363636364
1122,-0.16507071256637576,0.06651248954407248,2,0,2,0.0,1.0
1123,-0.059529247693717535,1.2854800109617326,2,1,1,0.5,0.5
1125,0.8667174143095812,0.09489138708736232,3,3,0,1.0,0.0
1127,-0.3281587778280178,1.0356614712811008,3,1,2,0.3333333333333333,0.6666666666666666
1128,0.7840389460325241,,1,1,0,1.0,0.0
1129,-0.28228630817362244,0.6264691014001865,7,2,5,0.2857142857142857,0.7142857142857143
1130,0.004992693662643433,,1,1,0,1.0,0.0
1131,0.23136902848879495,0.3313760642259955,3,2,1,0.6666666666666666,0.3333333333333333
1132,-0.14808522537350655,0.5541748641373183,4,2,2,0.5,0.5
1133,0.7600411027669907,0.045457335947455005,2,2,0,1.0,0.0
1134,-0.13770527889331183,0.5739791769389377,45,18,27,0.4,0.6
1135,-0.4620775952935219,0.45413363255990097,3,1,2,0.3333333333333333,0.6666666666666666
1136,-0.912948686629534,,1,0,1,0.0,1.0
1137,-0.31489668786525726,0.45239164893480766,2,1,1,0.5,0.5
1138,-0.25134930014610296,,1,0,1,0.0,1.0
1139,0.3893467359244823,0.5911145123500158,15,11,4,0.7333333333333333,0.26666666666666666
1141,-0.5280471742153168,,1,0,1,0.0,1.0
1142,-0.27730421784023446,0.5089431065933169,6,2,4,0.3333333333333333,0.6666666666666666
1143,0.2626490853726864,0.7269038250133345,2,1,1,0.5,0.5
1146,0.13287903368473053,0.45621171284328943,2,1,1,0.5,0.5
1147,0.015974630912145,0.13987943312845222,3,2,1,0.6666666666666666,0.3333333333333333
1148,-0.36141227185726166,0.3830759303494269,2,0,2,0.0,1.0
1149,-0.09287218749523166,0.04849068678163256,2,0,2,0.0,1.0
1150,0.13950883736833933,0.802685611478131,4,3,1,0.75,0.25
1151,0.13323277235031128,,1,1,0,1.0,0.0
1153,0.7287860959768295,,1,1,0,1.0,0.0
1154,-0.13173116650432354,1.1562999887644714,2,1,1,0.5,0.5
1155,0.4740569833666086,0.5088015417384,4,3,1,0.75,0.25
1157,0.6816780501976609,0.3984092607194309,2,2,0,1.0,0.0
1158,0.048104807734489476,0.6848199935576064,3,2,1,0.6666666666666666,0.3333333333333333
1159,0.4076619162224234,0.7965845846976578,2,1,1,0.5,0.5
1160,0.14211478829383856,,1,1,0,1.0,0.0
1161,0.1502364575862885,,1,1,0,1.0,0.0
1163,0.26500511169433594,0.8555908449868519,2,1,1,0.5,0.5
1164,0.004992514848709162,,1,1,0,1.0,0.0
1165,0.39881452545523643,0.5307793002121496,6,5,1,0.8333333333333334,0.16666666666666666
1168,-0.08133705332875252,0.6181459657141873,4,2,2,0.5,0.5
1169,-0.1936221718788147,0.11714299289802738,2,0,2,0.0,1.0
1170,0.5027586929500104,0.5525707829199351,2,2,0,1.0,0.0
1171,0.3689092604443431,0.5560430804243793,20,14,6,0.7,0.3
1172,0.1496998080611229,0.47145963618855213,25,16,9,0.64,0.36
1173,-0.6348369717597961,0.1424078369441858,2,0,2,0.0,1.0
1175,-0.005716145038604764,0.015145933627723429,2,1,1,0.5,0.5
1177,0.15392545672754446,0.6482893915196375,6,3,3,0.5,0.5
1178,-0.002160031348466873,0.7725463259459991,4,2,2,0.5,0.5
1179,0.5603851632525524,0.5000038486212822,3,2,1,0.6666666666666666,0.3333333333333333
1180,-0.6498373746871948,,1,0,1,0.0,1.0
1182,0.7579298317432404,,1,1,0,1.0,0.0
1183,-0.08245949149131775,0.3820588850575951,5,2,3,0.4,0.6
1185,0.16328685171902177,0.6973298643712225,6,4,2,0.6666666666666666,0.3333333333333333
1187,-0.11064277589321139,0.1635345980364234,2,1,1,0.5,0.5
1189,0.04133778328404708,0.45584332673675027,17,8,9,0.47058823529411764,0.5294117647058824
1190,0.16990244388580322,,1,1,0,1.0,0.0
1191,0.3268362782895565,0.5044636628552377,5,3,2,0.6,0.4
1193,-0.2024257853627205,0.34010876310656224,4,2,2,0.5,0.5
1194,0.3294846725960572,1.070703884602016,3,2,1,0.6666666666666666,0.3333333333333333
1195,0.25819006711244585,0.5362573858114904,5,4,1,0.8,0.2
1196,0.1990701854228973,0.744500836706255,4,2,2,0.5,0.5
1197,0.31027327105402946,0.6588556096766464,2,1,1,0.5,0.5
1198,0.4317839095989863,0.38965893368898424,3,3,0,1.0,0.0
1201,0.18140062454499697,0.5870899794101337,19,11,8,0.5789473684210527,0.42105263157894735
1202,0.11553770552078879,0.7101607026614813,3,2,1,0.6666666666666666,0.3333333333333333
1203,-0.521978508681059,0.5380305416521618,2,0,2,0.0,1.0
1204,0.32190678109015736,0.4403619786315917,28,20,8,0.7142857142857143,0.2857142857142857
1205,-0.8096734136343005,,1,0,1,0.0,1.0
1206,0.09950003710885842,0.6116322406540868,30,14,16,0.4666666666666667,0.5333333333333333
1209,0.0028990264981985313,0.8081487230314842,5,2,3,0.4,0.6
1211,-0.1556081771850586,,1,0,1,0.0,1.0
1212,-0.8431071341037751,,1,0,1,0.0,1.0
1213,0.11914087154648521,0.516923377409037,11,8,3,0.7272727272727273,0.2727272727272727
1215,0.2631636379020555,0.4311448455684419,7,4,3,0.5714285714285714,0.42857142857142855
1217,-0.5706530855968595,0.49845629839482747,3,0,3,0.0,1.0
1218,-0.08170326054096225,0.12260794293676824,2,1,1,0.5,0.5
1219,-0.21042832732200625,0.7692832663539201,4,2,2,0.5,0.5
1220,-0.20940518006682396,0.4894251230295593,4,1,3,0.25,0.75
1223,0.7859779223799706,,1,1,0,1.0,0.0
1224,-0.10541281178593634,0.5509642819898075,5,2,3,0.4,0.6
1226,0.07622709497809413,0.5553430423500338,4,3,1,0.75,0.25
1227,0.09717041887342928,0.7306507985820285,5,2,3,0.4,0.6
1228,0.24351462125778198,0.5128229642115861,5,4,1,0.8,0.2
1229,0.16618518458633888,0.46821478150994417,41,28,13,0.6829268292682927,0.3170731707317073
1231,-0.24875813403299876,0.5831566536424,7,3,4,0.42857142857142855,0.5714285714285714
1232,-0.5162016153335571,,1,0,1,0.0,1.0
1233,-0.6735763251781464,,1,0,1,0.0,1.0
1234,0.05584836751222616,0.8950308648356945,2,1,1,0.5,0.5
1235,0.2871258445084095,0.43570136712684565,4,3,1,0.75,0.25
1236,0.6560142487287521,,1,1,0,1.0,0.0
1237,0.15348160564899443,0.44449818456806445,5,2,3,0.4,0.6
1238,0.198846635222435,0.5122368242676176,5,3,2,0.6,0.4
1239,0.7270612716674805,,1,1,0,1.0,0.0
1240,0.4697467982769013,,1,1,0,1.0,0.0
1241,-0.7997501082718372,0.18137129710855954,2,0,2,0.0,1.0
1242,0.16333285346627235,0.4314219921424092,4,3,1,0.75,0.25
1244,0.8447293639183046,,1,1,0,1.0,0.0
1246,0.032107673585414886,0.892281309805965,2,1,1,0.5,0.5
1247,0.37114940397441387,0.7449482211207544,2,1,1,0.5,0.5
1249,0.2236047638580203,0.7205065917424067,8,4,4,0.5,0.5
1250,-0.3731059730052948,,1,0,1,0.0,1.0
1251,-0.44506606273353105,0.6364785649575112,2,1,1,0.5,0.5
1254,-0.5364285996183754,0.4053229936678363,4,1,3,0.25,0.75
1255,-0.26095348596572876,,1,0,1,0.0,1.0
1256,0.01180989295244217,0.8984409242018623,2,1,1,0.5,0.5
1257,0.21227254022501016,0.6063582931299084,19,13,6,0.6842105263157895,0.3157894736842105
1259,0.7587009519338608,,1,1,0,1.0,0.0
1260,0.23918989466296303,0.45185129456822454,9,6,3,0.6666666666666666,0.3333333333333333
1261,0.2386678159236908,,1,1,0,1.0,0.0
1262,0.2678308387597402,0.5018343502592215,3,2,1,0.6666666666666666,0.3333333333333333
1263,-0.25134968757629395,,1,0,1,0.0,1.0
1264,-0.8428364787250757,0.09245500486490336,2,0,2,0.0,1.0
1265,0.1938748814165592,0.6529389785252402,10,7,3,0.7,0.3
1266,0.39416663348674774,0.04859976282557872,2,2,0,1.0,0.0
1267,0.24749732336827687,0.5614682460048808,7,4,3,0.5714285714285714,0.42857142857142855
1268,0.721829729154706,0.2742652034487872,2,2,0,1.0,0.0
1269,-0.08949562907218939,,1,0,1,0.0,1.0
1270,0.0226145734389623,0.6770308102918016,3,2,1,0.6666666666666666,0.3333333333333333
1271,-0.46785485247770947,0.34378353926666594,3,0,3,0.0,1.0
1273,-0.5427302718162538,,1,0,1,0.0,1.0
1275,-0.5358619391918183,,1,0,1,0.0,1.0
1277,0.2010882765054703,0.4700617840490161,5,3,2,0.6,0.4
1278,0.06622528098523617,0.5599417698422481,4,2,2,0.5,0.5
1279,0.5057173886646827,0.5293728563047723,6,5,1,0.8333333333333334,0.16666666666666666
1280,-0.08696164935827255,0.33227937040136546,4,2,2,0.5,0.5
1282,0.1134789204224944,0.5237764299235532,12,6,6,0.5,0.5
1283,0.5633646473288536,0.15187746462459836,2,2,0,1.0,0.0
1284,-0.040030556917190575,0.7436858320312861,5,2,3,0.4,0.6
1285,-0.0444570817053318,0.3466528292616819,4,3,1,0.75,0.25
1286,-0.6423002332448959,,1,0,1,0.0,1.0
1287,0.8769009150564671,,1,1,0,1.0,0.0
1288,-0.07014577214916545,0.7411121050041026,3,2,1,0.6666666666666666,0.3333333333333333
1289,0.3954339232295752,0.41435882527442547,4,3,1,0.75,0.25
1290,-0.25135025382041937,0.0,2,0,2,0.0,1.0
1291,-0.8375056236982347,,1,0,1,0.0,1.0
1292,-0.7047989070415497,0.09731911054973948,4,0,4,0.0,1.0
1293,-0.25135025382041937,,1,0,1,0.0,1.0
1294,-0.3390093917647998,0.8224064984977038,3,1,2,0.3333333333333333,0.6666666666666666
1296,0.004992514848709162,,1,1,0,1.0,0.0
1297,0.86460392922163,,1,1,0,1.0,0.0
1298,-0.3088942468166352,,1,0,1,0.0,1.0
1299,-0.38192473351955414,0.06903929847942189,2,0,2,0.0,1.0
1300,0.3485763490200043,0.6758922998731963,5,4,1,0.8,0.2
1301,-0.5308522433042526,,1,0,1,0.0,1.0
1302,0.9301181100308896,,1,1,0,1.0,0.0
1305,0.2742078267037869,0.5853754115718622,4,2,2,0.5,0.5
1306,-0.48638533800840383,0.37723253944290985,4,0,4,0.0,1.0
1307,0.23818638920784002,0.3297851389908887,2,2,0,1.0,0.0
1308,0.46864062547683716,,1,1,0,1.0,0.0
1309,0.3195239454507828,0.4448138141599428,2,2,0,1.0,0.0
1310,0.24459430165588855,0.5380164412553206,10,8,2,0.8,0.2
1311,0.2532900720834732,0.7136678443145111,2,1,1,0.5,0.5
1312,0.2999372333288193,0.6896873411830253,2,1,1,0.5,0.5
1313,0.09730450063943868,0.8911996952326299,2,1,1,0.5,0.5
1314,-0.3233662992715836,0.43146009118546935,3,1,2,0.3333333333333333,0.6666666666666666
1315,-0.25134930014610296,,1,0,1,0.0,1.0
1316,0.6320994198322296,,1,1,0,1.0,0.0
1318,-0.02501827904156276,0.5138546829555621,7,2,5,0.2857142857142857,0.7142857142857143
1320,0.6321037709712983,,1,1,0,1.0,0.0
1321,0.16030730058749518,0.6294367516089392,6,4,2,0.6666666666666666,0.3333333333333333
1322,0.3784613862633705,0.2883948431054331,5,5,0,1.0,0.0
1323,0.45737165212631226,0.48384921518419655,5,4,1,0.8,0.2
1325,0.2822057008743286,0.2509439723831652,3,3,0,1.0,0.0
1326,0.3182322482268016,0.3978744396230005,3,3,0,1.0,0.0
1327,0.3098391613789967,0.5058271680003054,7,5,2,0.7142857142857143,0.2857142857142857
1331,-0.22075744420289994,0.5986748571531001,5,2,3,0.4,0.6
1332,0.1503081868092219,0.5437326641565294,6,4,2,0.6666666666666666,0.3333333333333333
1333,-0.15560820698738098,,1,0,1,0.0,1.0
1334,0.38271034935202736,0.4717668080599628,26,22,4,0.8461538461538461,0.15384615384615385
1337,0.8631971180438995,,1,1,0,1.0,0.0
1338,0.5921201556921005,,1,1,0,1.0,0.0
1339,-0.5004243031144142,0.28539369861058383,4,0,4,0.0,1.0
1340,-0.5328686088323593,,1,0,1,0.0,1.0
1341,0.11899629086256028,0.5669674872757934,5,4,1,0.8,0.2
1343,0.34970371052622795,0.9059190246976415,3,2,1,0.6666666666666666,0.3333333333333333
1344,0.8965757638216021,,1,1,0,1.0,0.0
1345,0.7607654854655266,,1,1,0,1.0,0.0
1346,0.2766070645302534,0.777318886999342,4,3,1,0.75,0.25
1347,-0.35392069816589355,,1,0,1,0.0,1.0
1349,0.5782690743605298,0.49836480432534896,3,3,0,1.0,0.0
1351,0.3444851338863373,0.766651773270452,3,2,1,0.6666666666666666,0.3333333333333333
1352,-0.7871240116655827,0.04242655080268063,2,0,2,0.0,1.0
1353,0.17380452528595924,0.800492186991495,6,4,2,0.6666666666666666,0.3333333333333333
1354,-0.16454210877418518,,1,0,1,0.0,1.0
1355,0.1135412156581879,0.15350944328250085,2,2,0,1.0,0.0
1356,0.3498292858712375,0.8036048114920612,4,3,1,0.75,0.25
1357,-0.01694951355457306,0.3436659043020495,5,2,3,0.4,0.6
1358,0.08565554022789001,0.1140731428930394,2,2,0,1.0,0.0
1359,-0.017543673515319824,,1,0,1,0.0,1.0
1360,-0.059648323059082034,0.15162139994237062,5,2,3,0.4,0.6
1362,-0.04293536022305483,0.6500287402326026,4,2,2,0.5,0.5
1363,0.08689930165807404,0.6345309003390119,6,4,2,0.6666666666666666,0.3333333333333333
1364,-0.8793202750384808,,1,0,1,0.0,1.0
1365,-0.43383390208085376,0.1252379281474694,3,0,3,0.0,1.0
1366,0.6296928450465202,0.4104660861793467,4,4,0,1.0,0.0
1368,0.48087422456592327,0.7241957997196682,4,3,1,0.75,0.25
1369,0.4560416179398696,0.3883584320572806,6,5,1,0.8333333333333334,0.16666666666666666
1371,-0.1191989379003644,0.6942551634286239,6,2,4,0.3333333333333333,0.6666666666666666
1372,-0.15932897726694742,0.9109610676247528,3,1,2,0.3333333333333333,0.6666666666666666
1373,0.6541763916611671,0.3948611369238052,3,3,0,1.0,0.0
1375,0.004992514848709162,,1,1,0,1.0,0.0
1378,0.34562325444338576,0.5202308601357426,14,10,4,0.7142857142857143,0.2857142857142857
1379,-0.9571288693696262,0.03253442994190459,2,0,2,0.0,1.0
1381,0.2673474432279666,0.6071493869879057,3,1,2,0.3333333333333333,0.6666666666666666
1382,-0.9666493125259875,,1,0,1,0.0,1.0
1383,0.010003656148910578,,1,1,0,1.0,0.0
1384,0.09035745263099676,,1,1,0,1.0,0.0
1385,-0.9162210188806057,,1,0,1,0.0,1.0
1386,-0.20295785974873148,0.6481530055490963,23,8,15,0.34782608695652173,0.6521739130434783
1387,-0.35649251937866216,,1,0,1,0.0,1.0
1388,-0.38194159269332884,0.20416605481279185,5,0,5,0.0,1.0
1389,-0.7599634453654289,,1,0,1,0.0,1.0
1390,0.63089419901371,,1,1,0,1.0,0.0
1391,-0.4336149245500565,0.6202842100338332,2,1,1,0.5,0.5
1392,0.6370546519756317,,1,1,0,1.0,0.0
1393,0.38293540664017195,0.7100783052281375,2,1,1,0.5,0.5
1394,0.4235170762985945,0.49461358191326554,4,3,1,0.75,0.25
1395,-0.29618965089321136,0.5342047526542342,4,2,2,0.5,0.5
1397,0.5286816945299506,0.40155070991903646,4,4,0,1.0,0.0
1398,0.24833375168964267,0.4866490065041414,8,5,3,0.625,0.375
1400,0.004992246627807617,,1,1,0,1.0,0.0
1401,-0.084963744195799,0.9066655687590014,3,1,2,0.3333333333333333,0.6666666666666666
1402,0.6400939375162126,,1,1,0,1.0,0.0
1404,0.4810114453236262,0.3092202322186797,3,3,0,1.0,0.0
1405,-0.33670453727245336,0.48323222601101773,2,1,1,0.5,0.5
1406,-0.8793490752577782,,1,0,1,0.0,1.0
1408,0.7170700654387474,0.05778443566320901,2,2,0,1.0,0.0
1410,-0.14392312872223556,0.824390963129078,8,3,5,0.375,0.625
1411,0.6155118644237518,0.20140942090882885,2,2,0,1.0,0.0
1412,0.8140166128675143,0.05343653981544797,3,3,0,1.0,0.0
1413,-0.1855076551437378,,1,0,1,0.0,1.0
1415,0.6961290240287782,,1,1,0,1.0,0.0
1416,-0.06214491277933121,0.38157250865020975,4,2,2,0.5,0.5
1417,-0.2247367665171623,0.6640753663066987,5,1,4,0.2,0.8
1418,-0.15560820698738098,,1,0,1,0.0,1.0
1421,0.43018336594104767,0.5079243487419991,4,3,1,0.75,0.25
1422,0.09683451056480413,,1,1,0,1.0,0.0
1424,0.7579303234815598,,1,1,0,1.0,0.0
1425,0.05317452549934393,,1,1,0,1.0,0.0
1426,0.6941834688186646,,1,1,0,1.0,0.0
1429,0.5448121264576912,0.343709285505414,5,4,1,0.8,0.2
1430,0.89776698499918,,1,1,0,1.0,0.0
1431,0.23408243060112008,0.19944621577214294,3,3,0,1.0,0.0
1432,0.29151904802112016,0.5634402619370236,17,12,5,0.7058823529411765,0.29411764705882354
1434,0.3942654430866242,0.5505148016976571,2,2,0,1.0,0.0
1435,0.6938566267490387,,1,1,0,1.0,0.0
1438,-0.15560799837112427,,1,0,1,0.0,1.0
1439,-0.24007802208264672,0.5145535426781371,3,1,2,0.3333333333333333,0.6666666666666666
1440,0.3425407057834996,0.5291898979156278,9,6,3,0.6666666666666666,0.3333333333333333
1442,-0.13218331336975098,,1,0,1,0.0,1.0
1445,-0.5475663095712662,,1,0,1,0.0,1.0
1447,-0.48359769210219394,0.662069538683269,2,0,2,0.0,1.0
1448,0.21582844108343124,0.26524670027820296,6,5,1,0.8333333333333334,0.16666666666666666
1450,-0.37103790044784546,0.4679666883917707,3,1,2,0.3333333333333333,0.6666666666666666
1451,-0.025266647338867198,0.38639045365662195,6,4,2,0.6666666666666666,0.3333333333333333
1452,-0.15560853481292725,,1,0,1,0.0,1.0
1453,-0.07460284233093262,,1,0,1,0.0,1.0
1454,0.19357141479849815,0.7968100630932012,2,1,1,0.5,0.5
1455,0.24738258495926857,0.43617180203545447,4,2,2,0.5,0.5
1456,-0.17138583709796265,0.6753625694623847,3,2,1,0.6666666666666666,0.3333333333333333
1458,0.2155020385980606,0.5293261639141729,4,3,1,0.75,0.25
1460,0.7171175479888916,,1,1,0,1.0,0.0
1462,0.28179472684860235,,1,1,0,1.0,0.0
1464,0.0049924552440643866,,1,1,0,1.0,0.0
1465,0.5905942413955928,0.3084045805775689,4,4,0,1.0,0.0
1466,-0.4125111401081086,,1,0,1,0.0,1.0
1467,0.25344046950340277,0.6453754694775581,3,2,1,0.6666666666666666,0.3333333333333333
1469,-0.15821440815925597,0.6010568933762004,5,2,3,0.4,0.6
1470,-0.2375719249248505,0.34675131071210064,2,1,1,0.5,0.5
1471,0.6283103227615358,0.1280181231458691,2,2,0,1.0,0.0
1472,0.30655766030152637,0.3738857483218779,6,5,1,0.8333333333333334,0.16666666666666666
1473,0.3421159200370312,0.3230526993729072,4,4,0,1.0,0.0
1474,0.004992246627807617,,1,1,0,1.0,0.0
1475,0.34514632262289524,0.40659344515331236,4,3,1,0.75,0.25
1480,0.14463901768128085,0.8637231204338254,3,2,1,0.6666666666666666,0.3333333333333333
1481,-0.3051027655601502,,1,0,1,0.0,1.0
1482,-0.41322634890675547,0.3969922871332456,5,1,4,0.2,0.8
1483,-0.09494185447692874,0.1689433663260992,2,1,1,0.5,0.5
1485,0.8160835579037667,,1,1,0,1.0,0.0
1486,-0.7909424901008606,,1,0,1,0.0,1.0
1487,0.1492269188165665,0.04422820740433181,2,2,0,1.0,0.0
1488,0.621365025639534,0.19313180093471358,2,2,0,1.0,0.0
1489,0.028109624981880188,0.25981654464865017,2,1,1,0.5,0.5
1490,0.08265720059474309,0.5785165906753931,3,1,2,0.3333333333333333,0.6666666666666666
1491,-0.08238673210144043,,1,0,1,0.0,1.0
1492,0.004992246627807617,,1,1,0,1.0,0.0
1493,0.023748385719955023,0.8488742955368768,4,2,2,0.5,0.5
1494,-0.3631033003330231,,1,0,1,0.0,1.0
1495,0.4300567088648677,0.6869595748197702,6,5,1,0.8333333333333334,0.16666666666666666
1496,0.45455320179462433,0.006051465582618361,2,2,0,1.0,0.0
1497,0.4152849495410919,0.3747791737505352,5,4,1,0.8,0.2
1498,0.2632672488689423,,1,1,0,1.0,0.0
1499,-0.07292242348194122,0.5994750784085515,6,2,4,0.3333333333333333,0.6666666666666666
1500,0.7185327708721161,,1,1,0,1.0,0.0
1503,-0.15371964871883398,0.1380691771382016,2,0,2,0.0,1.0
1505,0.004992246627807617,,1,1,0,1.0,0.0
1508,-0.2952419579029083,0.6100192409474741,5,2,3,0.4,0.6
1509,-0.3328407406806946,,1,0,1,0.0,1.0
1512,-0.27301403880119324,,1,0,1,0.0,1.0
1514,0.570903554558754,0.19894073247757602,2,2,0,1.0,0.0
1515,-0.01660281543930377,0.9025395555828708,3,1,2,0.3333333333333333,0.6666666666666666
1516,-0.34896862506866455,0.13805356173082833,2,0,2,0.0,1.0
1518,-0.48552335798740387,0.06695631693231648,2,0,2,0.0,1.0
1519,0.8542245179414749,,1,1,0,1.0,0.0
1521,0.8604468628764155,,1,1,0,1.0,0.0
1523,0.8705619722604752,,1,1,0,1.0,0.0
1525,-0.8387497216463089,,1,0,1,0.0,1.0
1526,-0.004519994370639324,0.6512384580897739,4,2,2,0.5,0.5
1528,0.9323834478855135,,1,1,0,1.0,0.0
1530,-0.939604675397277,,1,0,1,0.0,1.0
1531,0.4723197917143504,0.6267424280466866,3,2,1,0.6666666666666666,0.3333333333333333
1532,0.17043808102607733,,1,1,0,1.0,0.0
1533,0.3363206237554551,0.01575999213710286,2,2,0,1.0,0.0
1534,0.6916363090276718,,1,1,0,1.0,0.0
1536,-0.3393068611621857,,1,0,1,0.0,1.0
1537,0.004993647336959839,,1,1,0,1.0,0.0
1540,-0.1314029097557068,,1,0,1,0.0,1.0
1545,0.22137795140345895,0.48871160883345444,3,2,1,0.6666666666666666,0.3333333333333333
1546,-0.2414412945508957,0.08496815196508364,2,0,2,0.0,1.0
1547,0.10493757575750352,0.47743436083437873,4,2,2,0.5,0.5
1548,-0.3628486767411232,0.29308181938297984,2,0,2,0.0,1.0
1549,0.22275743385155997,0.5523253139399594,9,6,3,0.6666666666666666,0.3333333333333333
1551,-0.09025070071220398,,1,0,1,0.0,1.0
1552,-0.5201303362846375,,1,0,1,0.0,1.0
1553,0.5369328845824515,0.6177786347522372,7,6,1,0.8571428571428571,0.14285714285714285
1554,-0.12875781953334806,0.1891523376451635,2,1,1,0.5,0.5
1555,0.7852724418044091,,1,1,0,1.0,0.0
1557,0.3988279923796654,0.339878750763505,2,2,0,1.0,0.0
1558,0.1723903506062926,1.1293088236327415,2,1,1,0.5,0.5
1559,0.21048016846179962,0.5771983722289828,4,3,1,0.75,0.25
1560,0.04879876375198361,0.730488828027603,5,2,3,0.4,0.6
1561,-0.033007226884365075,0.4022796027603247,8,5,3,0.625,0.375
1562,-0.23709405362606048,0.2958264490448171,5,1,4,0.2,0.8
1563,0.2639388293027878,0.6568203436304114,2,1,1,0.5,0.5
1564,0.10522771812975412,0.7518337368386612,4,2,2,0.5,0.5
1565,0.4548281704386075,0.5669844574306421,3,2,1,0.6666666666666666,0.3333333333333333
1566,0.6325601190328598,,1,1,0,1.0,0.0
1567,0.6221852898597717,,1,1,0,1.0,0.0
1568,-0.055829256772994995,,1,0,1,0.0,1.0
1569,-0.23604387044906622,,1,0,1,0.0,1.0
1570,0.5405106609687209,0.304280020198261,8,7,1,0.875,0.125
1571,-0.8761017844080926,,1,0,1,0.0,1.0
1573,0.36736714094877243,0.4882874138518234,2,2,0,1.0,0.0
1574,-0.2753549340284533,0.7005536110601421,9,3,6,0.3333333333333333,0.6666666666666666
1575,0.3800271302461624,0.017023006746428822,2,2,0,1.0,0.0
1579,-0.2525329887866974,0.2327972772908804,8,2,6,0.25,0.75
1580,0.6676115728914738,0.16914156714957768,2,2,0,1.0,0.0
1583,0.10134338960051537,0.8992140242373239,5,3,2,0.6,0.4
1584,0.49819448590278625,,1,1,0,1.0,0.0
1586,0.08159111440181732,0.10832517676654792,2,2,0,1.0,0.0
1587,-0.17725993916392327,0.7318284228599008,5,2,3,0.4,0.6
1590,-0.9135060869157314,,1,0,1,0.0,1.0
1592,-0.1673962771892548,0.029219693576178186,2,0,2,0.0,1.0
1595,0.008435657868782698,0.6902148506154315,6,3,3,0.5,0.5
1599,0.513608917593956,0.4882373806875705,3,2,1,0.6666666666666666,0.3333333333333333
1600,0.4300992538531621,0.7251748817311361,3,2,1,0.6666666666666666,0.3333333333333333
1601,0.004992246627807617,,1,1,0,1.0,0.0
1602,0.22944880742579699,0.5448541347210644,4,2,2,0.5,0.5
1603,-0.25952942172686266,0.2763615878592216,3,0,3,0.0,1.0
1604,0.6141285747289658,0.24612050475654995,2,2,0,1.0,0.0
1606,-0.21181886177510023,0.6492018957536122,4,2,2,0.5,0.5
1609,-0.41915938630700117,0.5998409917991013,2,1,1,0.5,0.5
1610,0.8672604933381081,,1,1,0,1.0,0.0
1611,-0.5328768640756607,,1,0,1,0.0,1.0
1612,0.0049924552440643866,,1,1,0,1.0,0.0
1613,-0.2203048219283422,0.5623140074659605,3,1,2,0.3333333333333333,0.6666666666666666
1614,-0.4833720624446869,0.19683374830024367,2,0,2,0.0,1.0
1616,0.3390234652906656,0.7369304881771089,4,3,1,0.75,0.25
1619,-0.37300550937652593,,1,0,1,0.0,1.0
1621,-0.3471066455046336,0.10525676051864861,3,0,3,0.0,1.0
1624,0.10170015266963416,0.7258892872700076,7,4,3,0.5714285714285714,0.42857142857142855
1627,-0.3912712335586548,,1,0,1,0.0,1.0
1628,0.7839240878820419,,1,1,0,1.0,0.0
1630,0.5667425096035004,,1,1,0,1.0,0.0
1631,0.7539489716291428,0.005629238454236284,2,2,0,1.0,0.0
1632,0.01654490828514099,,1,1,0,1.0,0.0
1634,0.8729962874203921,0.036298438541867005,2,2,0,1.0,0.0
1637,0.6790122091770172,0.15246940657522184,2,2,0,1.0,0.0
1640,0.7569662556052208,,1,1,0,1.0,0.0
1641,0.4291238784790039,0.41472756030495644,2,2,0,1.0,0.0
1643,0.4364873496815562,0.5894190284457753,8,7,1,0.875,0.125
1649,0.9604246616363527,,1,1,0,1.0,0.0
1651,0.004992514848709162,,1,1,0,1.0,0.0
1652,-0.9514514841139318,,1,0,1,0.0,1.0
1656,0.2384906634688377,0.5573403046898902,2,1,1,0.5,0.5
1657,0.2960432469844818,,1,1,0,1.0,0.0
1658,0.6110720057040453,0.41559945479427934,2,2,0,1.0,0.0
1659,-0.1570777396361033,0.29406693452866345,6,1,5,0.16666666666666666,0.8333333333333334
1661,0.2172081172466278,,1,1,0,1.0,0.0
1662,0.3879324421286583,0.4860650526766925,2,2,0,1.0,0.0
1664,-0.10395723395049572,0.9250375501448834,3,1,2,0.3333333333333333,0.6666666666666666
1668,-0.532868891954422,,1,0,1,0.0,1.0
1670,-0.004020601511001587,,1,0,1,0.0,1.0
1671,-0.09613198041915898,0.26884428398172994,3,1,2,0.3333333333333333,0.6666666666666666
1674,-0.14944636821746823,0.2184095629899406,2,1,1,0.5,0.5
1677,-0.5568971782922745,,1,0,1,0.0,1.0
1679,-0.0007328093051910123,0.008096831067427892,2,1,1,0.5,0.5
1680,0.2879776008427143,0.7948187672052055,5,3,2,0.6,0.4
1682,-0.8150901496410369,,1,0,1,0.0,1.0
1683,0.4630736075341701,0.45995409105949414,4,3,1,0.75,0.25
1684,-0.474329466931522,0.7380584251174792,4,1,3,0.25,0.75
1685,0.09194136410951612,0.7785947167340432,2,1,1,0.5,0.5
1688,0.6115068420767784,0.28972914295105945,2,2,0,1.0,0.0
1689,0.485733337700367,0.2874303063193055,2,2,0,1.0,0.0
1690,0.21003560721874243,0.2899739213104986,2,2,0,1.0,0.0
1691,0.6472615748643875,,1,1,0,1.0,0.0
1693,-0.1560232490301132,0.22771059273959746,2,1,1,0.5,0.5
1694,0.6391856372356415,,1,1,0,1.0,0.0
1695,0.38158413767814636,,1,1,0,1.0,0.0
1696,-0.17280622323354086,0.3723087709217659,3,1,2,0.3333333333333333,0.6666666666666666
1700,0.9349189512431623,,1,1,0,1.0,0.0
1701,0.006423234939575195,,1,1,0,1.0,0.0
1702,-0.6780325770378113,0.156721117432728,2,0,2,0.0,1.0
1703,0.0049924552440643866,,1,1,0,1.0,0.0
1706,0.07668471833070119,0.6483789910019853,3,2,1,0.6666666666666666,0.3333333333333333
1710,0.7997056916356088,,1,1,0,1.0,0.0
1711,-0.4976279139518738,,1,0,1,0.0,1.0
1713,0.004992514848709162,,1,1,0,1.0,0.0
1715,-0.15560844540596014,,1,0,1,0.0,1.0
1717,0.647260919213295,,1,1,0,1.0,0.0
1718,-0.8801097907125952,,1,0,1,0.0,1.0
1719,0.7455098479986191,,1,1,0,1.0,0.0
1723,-0.15560844540596014,,1,0,1,0.0,1.0
1726,0.6335320472717285,,1,1,0,1.0,0.0
1727,0.21817182749509811,0.32562170312948074,4,3,1,0.75,0.25
1728,0.43539363145828247,,1,1,0,1.0,0.0
1729,-0.10819144546985629,0.10738020228250585,4,1,3,0.25,0.75
1733,0.8381105139851571,,1,1,0,1.0,0.0
1734,-0.6383123248815538,,1,0,1,0.0,1.0
1735,0.6397983282804489,,1,1,0,1.0,0.0
1739,0.6950867474079132,,1,1,0,1.0,0.0
1740,-0.15560844540596014,,1,0,1,0.0,1.0
1742,0.35129454794029397,0.5987046556996105,6,4,2,0.6666666666666666,0.3333333333333333
1744,-0.7003240287303925,,1,0,1,0.0,1.0
1745,0.7715107469509045,0.315109018540755,3,3,0,1.0,0.0
1747,0.441239507868886,0.6169456132834933,2,2,0,1.0,0.0
1750,0.29929858818650246,0.643335317203737,2,1,1,0.5,0.5
1753,0.6990614980459213,,1,1,0,1.0,0.0
1755,-0.555195063352585,0.0,2,0,2,0.0,1.0
1756,0.40990424342453474,0.6804111818669459,4,3,1,0.75,0.25
1758,0.96095878072083,,1,1,0,1.0,0.0
1762,0.16920179128646856,,1,1,0,1.0,0.0
1764,0.06354553699493408,0.42557000934414463,5,2,3,0.4,0.6
1765,-0.950112933292985,,1,0,1,0.0,1.0
1767,0.8786793556064367,0.05702772851086654,2,2,0,1.0,0.0
1770,0.591630220413208,,1,1,0,1.0,0.0
1772,0.3439970416948199,0.8560788778337387,2,1,1,0.5,0.5
1774,0.41865620017051697,,1,1,0,1.0,0.0
1775,0.8427092581987381,,1,1,0,1.0,0.0
1776,-0.03296094139417014,0.2460222645151382,3,1,2,0.3333333333333333,0.6666666666666666
1777,0.2807730035856366,0.6017762056558645,4,2,2,0.5,0.5
1778,0.03488588333129883,,1,1,0,1.0,0.0
1780,-0.37357453256845474,0.2822071316770475,2,0,2,0.0,1.0
1783,0.2624820917844773,0.8758027936650491,3,2,1,0.6666666666666666,0.3333333333333333
1785,0.6945173144340515,,1,1,0,1.0,0.0
1786,0.8134751170873643,,1,1,0,1.0,0.0
1787,0.7399763911962509,,1,1,0,1.0,0.0
1788,0.35659603774547577,0.5348010621508954,3,2,1,0.6666666666666666,0.3333333333333333
1791,-0.9169813655316831,,1,0,1,0.0,1.0
1792,-0.8762034960091115,,1,0,1,0.0,1.0
1794,0.28258975595235825,0.36394127166219314,2,2,0,1.0,0.0
1795,-0.6529465466737747,,1,0,1,0.0,1.0
1797,0.5914724953472615,0.518806615939782,2,2,0,1.0,0.0
1799,0.015166252851486206,,1,1,0,1.0,0.0
1801,-0.4147902677456538,0.5019371232342079,3,1,2,0.3333333333333333,0.6666666666666666
1802,0.004993647336959839,,1,1,0,1.0,0.0
1804,-0.4495858382433653,0.6837853467644727,2,1,1,0.5,0.5
1805,0.7025079764425755,0.11093228071666661,2,2,0,1.0,0.0
1806,0.6739493285616239,0.18862713732907582,3,3,0,1.0,0.0
1808,-0.9260804541409017,,1,0,1,0.0,1.0
1809,0.48067018762230873,0.4234953323221853,2,2,0,1.0,0.0
1813,-0.31891151517629623,0.46009327954046086,2,1,1,0.5,0.5
1816,-0.2806483792761962,0.6487972860168947,6,3,3,0.5,0.5
1818,0.8710718904621899,0.15202678103070494,2,2,0,1.0,0.0
1819,0.25358177721500397,0.3515586856203744,2,2,0,1.0,0.0
1820,-0.5328686088323593,,1,0,1,0.0,1.0
1822,0.9137090835720301,0.02838048923623163,2,2,0,1.0,0.0
1823,0.28574654956658685,0.4753712316136212,3,2,1,0.6666666666666666,0.3333333333333333
1824,0.5040317103266716,0.4393953979962533,3,3,0,1.0,0.0
1829,0.7260273844003677,,1,1,0,1.0,0.0
1830,-0.4504808187484742,,1,0,1,0.0,1.0
1831,0.5071257799863815,,1,1,0,1.0,0.0
1832,-0.8178059160709383,,1,0,1,0.0,1.0
1833,-0.2513500154018402,0.0,2,0,2,0.0,1.0
1836,0.43741580854856493,0.5931373377958054,213,164,49,0.7699530516431925,0.2300469483568075
1839,-0.8538632243871689,,1,0,1,0.0,1.0
1841,0.7697169333696365,,1,1,0,1.0,0.0
1842,-0.7888514474034309,,1,0,1,0.0,1.0
1845,-0.6632431000471115,,1,0,1,0.0,1.0
1846,-0.2513500154018402,0.0,2,0,2,0.0,1.0
1847,-0.006529271602630615,,1,0,1,0.0,1.0
1848,0.23185255378484723,0.566042828117268,2,1,1,0.5,0.5
1853,-0.254764586687088,0.1402278333518083,2,0,2,0.0,1.0
1857,0.7569200694561005,,1,1,0,1.0,0.0
1858,0.3944978192448616,0.5154757768437462,2,2,0,1.0,0.0
1860,0.6342054605484009,,1,1,0,1.0,0.0
1863,0.5865351594984531,0.22074869986426343,4,4,0,1.0,0.0
1864,0.8557444587349893,,1,1,0,1.0,0.0
1865,-0.8397615700960159,,1,0,1,0.0,1.0
1866,0.7620665580034256,0.02348536195517995,2,2,0,1.0,0.0
1867,0.2227847576141358,,1,1,0,1.0,0.0
1869,-0.49134325981140137,,1,0,1,0.0,1.0
1871,0.7757069393992424,0.10854822842557982,2,2,0,1.0,0.0
1872,0.4863151013851166,,1,1,0,1.0,0.0
1875,0.7497360147535801,0.16634879052670035,2,2,0,1.0,0.0
1876,-0.1549996733665466,0.48334380979245023,2,1,1,0.5,0.5
1878,-0.15560859441757202,,1,0,1,0.0,1.0
1881,0.00499233603477478,,1,1,0,1.0,0.0
1882,-0.2551230490207672,,1,0,1,0.0,1.0
1885,-0.9465285623446107,0.02330013840977571,2,0,2,0.0,1.0
1886,-0.0011152327060699834,0.6066667546207993,3,1,2,0.3333333333333333,0.6666666666666666
1888,-0.8617859780788423,,1,0,1,0.0,1.0
1890,-0.8989132717251778,,1,0,1,0.0,1.0
1891,-0.16840064525604254,,1,0,1,0.0,1.0
1892,0.6054865941405296,0.3826898336069309,2,2,0,1.0,0.0
1893,-0.25135025382041937,,1,0,1,0.0,1.0
1897,0.7446096390485764,,1,1,0,1.0,0.0
1898,0.7903806120157242,,1,1,0,1.0,0.0
1899,0.3599013984203339,,1,1,0,1.0,0.0
1902,0.019014825423558573,0.17566145735269878,3,2,1,0.6666666666666666,0.3333333333333333
1903,0.07716518715023993,0.716299422188737,5,2,3,0.4,0.6
1908,0.7340644747018814,,1,1,0,1.0,0.0
1910,0.7648579453428587,0.017614820919291004,3,3,0,1.0,0.0
1911,0.5589449107646942,,1,1,0,1.0,0.0
1912,-0.8976444862782955,,1,0,1,0.0,1.0
1915,-0.27154532074928284,,1,0,1,0.0,1.0
1916,-0.3274134087065855,1.0437461422706493,3,1,2,0.3333333333333333,0.6666666666666666
1921,0.7447980493307114,,1,1,0,1.0,0.0
1922,0.20275835072000817,0.784607187056189,3,2,1,0.6666666666666666,0.3333333333333333
1927,-0.9541847370564939,,1,0,1,0.0,1.0
1928,0.783275593072176,0.09155495101241926,2,2,0,1.0,0.0
1929,0.5645177364349365,,1,1,0,1.0,0.0
1930,0.8298072814941408,,1,1,0,1.0,0.0
1933,-0.2738819345831871,0.48080567389156365,2,1,1,0.5,0.5
1934,0.8896504752337933,,1,1,0,1.0,0.0
1937,0.12877470254898077,,1,1,0,1.0,0.0
1938,0.8263630270957947,,1,1,0,1.0,0.0
1942,-0.8568121939897538,,1,0,1,0.0,1.0
1943,0.20553717017173773,,1,1,0,1.0,0.0
1945,-0.18554243445396423,,1,0,1,0.0,1.0
1946,-0.040857672691345215,,1,0,1,0.0,1.0
1947,-0.08970676610867183,0.8166827467126239,3,1,2,0.3333333333333333,0.6666666666666666
1951,-0.42563825845718384,,1,0,1,0.0,1.0
1952,0.17433580756187436,0.8290904660765966,2,1,1,0.5,0.5
1953,0.2160146622066173,0.6052980381325906,1333,852,481,0.6391597899474869,0.36084021005251316
1954,-0.08065441734323356,0.6102237393657981,292,116,176,0.3972602739726027,0.6027397260273972
1955,0.22759957916384843,0.6011567070036407,1998,1232,766,0.6166166166166166,0.3833833833833834
1956,0.29664646067954215,0.5636292457713098,97,67,30,0.6907216494845361,0.30927835051546393
1957,-0.19759687891363595,0.5927156266441188,237,80,157,0.33755274261603374,0.6624472573839663
1958,-0.36943929948444876,0.5630927661110658,119,26,93,0.2184873949579832,0.7815126050420168
1959,0.14736086359214154,0.5466445284690721,446,242,204,0.5426008968609866,0.45739910313901344
1960,0.05848831439183818,0.5362469601212458,45,21,24,0.4666666666666667,0.5333333333333333
1961,0.12393331086444999,0.5468346079181106,1464,782,682,0.5341530054644809,0.46584699453551914
1962,0.18858694831266049,0.5370328650066164,470,301,169,0.6404255319148936,0.3595744680851064
1963,0.05197656648634402,0.5864226741790215,1998,993,1005,0.496996996996997,0.503003003003003
1964,0.21305036553202716,0.529545716460347,133,83,50,0.6240601503759399,0.37593984962406013
1965,0.05237176892597501,0.5872287186463611,1025,544,481,0.5307317073170732,0.4692682926829268
1966,0.11142343157302406,0.5640682325552087,534,287,247,0.5374531835205992,0.46254681647940077
1967,0.23172118887506266,0.5883199411509401,1390,886,504,0.637410071942446,0.36258992805755397
1968,0.18417265314784964,0.5798273062650596,571,329,242,0.5761821366024519,0.4238178633975482
1969,0.05841695474924561,0.6045105558859626,767,380,387,0.4954367666232073,0.5045632333767927
1970,-0.009931723975266043,0.7152774767072956,24,11,13,0.4583333333333333,0.5416666666666666
1971,-0.16906697601856047,0.5570260411787427,48,16,32,0.3333333333333333,0.6666666666666666
1972,0.1837487928569317,0.5655207670743814,46,27,19,0.5869565217391305,0.41304347826086957
1973,0.06829774630486324,0.5760133998544876,465,243,222,0.5225806451612903,0.4774193548387097
1974,0.15824105794953053,0.5700501410129057,1075,627,448,0.5832558139534884,0.41674418604651164
1975,-0.1329490613874312,0.581417950530124,254,103,151,0.40551181102362205,0.594488188976378
1976,-0.5090749969404078,0.535273000488981,398,71,327,0.17839195979899497,0.821608040201005
1977,-0.18354662506572106,0.6562872221561787,1319,464,855,0.35178165276724793,0.6482183472327521
1978,0.08931107069184253,0.6124131051859752,77,44,33,0.5714285714285714,0.42857142857142855
1979,-0.04707127741114659,0.5638825835148522,275,119,156,0.43272727272727274,0.5672727272727273
1980,0.14740434370469302,0.5397270981386196,32,21,11,0.65625,0.34375
1981,0.04887712337076665,0.5888026299707224,60,30,30,0.5,0.5
1982,-0.045420308633908335,0.6162212123987255,204,104,100,0.5098039215686274,0.49019607843137253
1983,0.35075914934277536,0.5165297176864764,60,45,15,0.75,0.25
1984,0.0018714117007209109,0.5087067319737263,77,36,41,0.4675324675324675,0.5324675324675324
1985,-0.01391709716131924,0.5697339281700937,141,60,81,0.425531914893617,0.574468085106383
1986,0.19943014131676332,0.6548206817479707,255,157,98,0.615686274509804,0.3843137254901961
1987,-0.3319702398458723,0.5926735653343641,467,122,345,0.26124197002141325,0.7387580299785867
1988,-0.06034127162693123,0.5849157075324468,659,265,394,0.40212443095599393,0.5978755690440061
1989,0.04083722174735898,0.5879434206687296,177,87,90,0.4915254237288136,0.5084745762711864
1990,0.08263248857666752,0.5813835405956262,335,167,168,0.49850746268656715,0.5014925373134328
1991,0.19138958923136576,0.5637379086344129,195,119,76,0.6102564102564103,0.38974358974358975
1992,-0.13592541369856623,0.5024699586922121,49,15,34,0.30612244897959184,0.6938775510204082
1993,-0.0077931738003741815,0.5931091057698671,43,19,24,0.4418604651162791,0.5581395348837209
1994,0.06743684893724723,0.5810330392888358,208,108,100,0.5192307692307693,0.4807692307692308
1995,0.02142403958444025,0.5999207176328809,355,180,175,0.5070422535211268,0.49295774647887325
1996,0.23663239367306232,0.5885256912163193,30,18,12,0.6,0.4
1997,0.07077457771719067,0.5490740846078168,316,166,150,0.5253164556962026,0.47468354430379744
1998,-0.05046829830122288,0.5248579245010524,61,26,35,0.4262295081967213,0.5737704918032787
1999,0.2805654642129825,0.5432256146585411,88,63,25,0.7159090909090909,0.2840909090909091
2000,0.004117960575968048,0.47314651648287115,16,8,8,0.5,0.5
2001,0.04272271924724328,0.6184287151916106,271,130,141,0.4797047970479705,0.5202952029520295
2002,0.43471880603719176,0.4847182836969183,298,244,54,0.8187919463087249,0.18120805369127516
2003,-0.048353251946323075,0.5347352568985838,17,5,12,0.29411764705882354,0.7058823529411765
2004,0.20528998808003962,0.5893140444440467,304,186,118,0.6118421052631579,0.3881578947368421
2005,0.3311014309133354,0.5170911111753688,95,68,27,0.7157894736842105,0.28421052631578947
2006,0.07652441286735205,0.5943918993606444,239,122,117,0.5104602510460251,0.4895397489539749
2007,0.025969567033462225,0.5981513543382951,160,78,82,0.4875,0.5125
2008,0.2351700720206207,0.6220398731018304,49,31,18,0.6326530612244898,0.3673469387755102
2009,0.014834602503105998,0.6049303904055402,440,228,212,0.5181818181818182,0.4818181818181818
2010,0.007375703539785953,0.49735003204642025,86,39,47,0.45348837209302323,0.5465116279069767
2011,0.0578846629923926,0.5563881117230677,130,64,66,0.49230769230769234,0.5076923076923077
2012,-0.1693019032685293,0.5788746591566454,90,34,56,0.37777777777777777,0.6222222222222222
2013,-0.1519862285256386,0.667329245779522,25,9,16,0.36,0.64
2014,-0.11386064136106717,0.6285208486554228,19,7,12,0.3684210526315789,0.631578947368421
2015,0.09940308998436818,0.6144687793434122,523,284,239,0.5430210325047801,0.4569789674952199
2016,0.1254356764256954,0.7628658316112531,8,5,3,0.625,0.375
2017,0.10969944100494515,0.5363020566062793,437,250,187,0.5720823798627003,0.4279176201372998
2018,0.022852855213866465,0.5489645834972924,127,64,63,0.5039370078740157,0.49606299212598426
2019,0.14791617855163558,0.6068768451131714,392,223,169,0.5688775510204082,0.43112244897959184
2020,0.04137298445398575,0.6271809122908588,298,143,155,0.4798657718120805,0.5201342281879194
2021,0.11752848715654442,0.6582681261089762,35,21,14,0.6,0.4
2022,-0.0914906090186964,0.6399585585637778,439,179,260,0.40774487471526194,0.592255125284738
2023,0.028925467851943304,0.6152724510473442,193,93,100,0.48186528497409326,0.5181347150259067
2024,0.2534646343847271,0.6011665946903546,64,44,20,0.6875,0.3125
2025,0.1438401925355889,0.550696521809941,43,25,18,0.5813953488372093,0.4186046511627907
2026,0.17437409758567812,0.5644149535901477,15,10,5,0.6666666666666666,0.3333333333333333
2027,-0.1553393628448248,0.5928347776822224,25,9,16,0.36,0.64
2028,-0.012729364695648353,0.6200570983806704,105,45,60,0.42857142857142855,0.5714285714285714
2029,0.23838677732046784,0.6287936340885344,41,28,13,0.6829268292682927,0.3170731707317073
2030,0.21163709341144224,0.6109817663233645,265,169,96,0.6377358490566037,0.3622641509433962
2031,-0.2561920064294504,0.5543021970194211,36,11,25,0.3055555555555556,0.6944444444444444
2032,-0.26342507367107,0.6068801326946501,11,4,7,0.36363636363636365,0.6363636363636364
2033,0.12756848614662888,0.6358202274820801,16,7,9,0.4375,0.5625
2034,-0.1656838638296762,0.6450228071963033,77,30,47,0.38961038961038963,0.6103896103896104
2035,-0.022474317656209056,0.639750034695823,12,5,7,0.4166666666666667,0.5833333333333334
2036,-0.18785055825377212,0.6010070760901847,17,5,12,0.29411764705882354,0.7058823529411765
2037,0.26401934361927315,0.617744386771761,73,44,29,0.6027397260273972,0.3972602739726027
2038,0.21479630506095979,0.5970703199333537,390,245,145,0.6282051282051282,0.3717948717948718
2039,-0.1319741864007578,0.6591322130662911,67,24,43,0.3582089552238806,0.6417910447761194
2040,-0.33347561789883506,0.30793222503708,9,1,8,0.1111111111111111,0.8888888888888888
2041,-0.2535959726665169,0.7150534340177174,8,3,5,0.375,0.625
2042,0.06484322758534779,0.6060794538852137,13,8,5,0.6153846153846154,0.38461538461538464
2043,0.009432258705298105,0.5581853938647099,12,6,6,0.5,0.5
2044,-0.05543291632288186,0.6002185775494767,129,58,71,0.4496124031007752,0.5503875968992248
2045,0.2476141709194053,0.5756311172912821,32,20,12,0.625,0.375
2046,-0.48993553284905916,0.5377190945654146,234,40,194,0.17094017094017094,0.8290598290598291
2047,-0.12184448966469902,0.5112024567458126,52,20,32,0.38461538461538464,0.6153846153846154
2048,0.1391742067017521,0.6123070411022191,52,30,22,0.5769230769230769,0.4230769230769231
2049,-0.0466666799387272,0.6940007144937148,187,86,101,0.45989304812834225,0.5401069518716578
2050,-0.10057992302831642,0.5933983951369949,98,39,59,0.3979591836734694,0.6020408163265306
2051,0.20860564742575993,0.572798584596208,11,8,3,0.7272727272727273,0.2727272727272727
2052,0.23084692458311717,0.5400985442037709,15,11,4,0.7333333333333333,0.26666666666666666
2053,0.34766494086943567,0.6255686189368946,32,23,9,0.71875,0.28125
2054,-0.06423504804726692,0.6512213990482715,200,92,108,0.46,0.54
2055,0.08662072732113303,0.6557590738770194,32,19,13,0.59375,0.40625
2056,-0.15975800779415295,0.6994625516511709,64,23,41,0.359375,0.640625
2057,-0.49184384047985075,0.36348187040788094,5,1,4,0.2,0.8
2058,-0.2697352564060374,0.6339315281377313,19,6,13,0.3157894736842105,0.6842105263157895
2059,-0.13472890459694142,0.5579139731575831,43,18,25,0.4186046511627907,0.5813953488372093
2060,0.23222500876290725,0.5981834657732698,80,49,31,0.6125,0.3875
2061,0.12084297900303052,0.5279761937041223,104,61,43,0.5865384615384616,0.41346153846153844
2062,0.2238412853391645,0.5741911288865139,152,99,53,0.6513157894736842,0.34868421052631576
2063,0.18312499080631103,0.6142367411671328,91,55,36,0.6043956043956044,0.3956043956043956
2064,-0.03143455485502879,0.5472132927038341,15,7,8,0.4666666666666667,0.5333333333333333
2065,0.20768887922167778,0.6153014362219339,13,9,4,0.6923076923076923,0.3076923076923077
2066,0.011882031181206306,0.4800514807590479,72,33,39,0.4583333333333333,0.5416666666666666
2067,-0.3764859636624655,0.18466755080586023,3,0,3,0.0,1.0
2068,0.2384634268063135,0.5932470404540453,849,546,303,0.6431095406360424,0.3568904593639576
2069,0.2033435743716028,0.6209023441224948,9,6,3,0.6666666666666666,0.3333333333333333
2070,0.43639621491494934,0.4162825473481734,19,16,3,0.8421052631578947,0.15789473684210525
2071,-0.0027117620814930713,0.596198457526866,22,10,12,0.45454545454545453,0.5454545454545454
2072,-0.2964147385209799,0.4925911208040319,9,3,6,0.3333333333333333,0.6666666666666666
2073,-0.01830463483929633,0.38304005698347904,10,4,6,0.4,0.6
2074,0.02564183877541699,0.587233602558488,179,85,94,0.4748603351955307,0.5251396648044693
2075,0.23275279839124,0.5595484028010683,42,26,16,0.6190476190476191,0.38095238095238093
2076,0.6375959552824497,0.2264487424369615,2,2,0,1.0,0.0
2077,0.2730909684259031,0.6606190445315824,9,7,2,0.7777777777777778,0.2222222222222222
2078,0.10843429822420729,0.5051991712196641,69,39,30,0.5652173913043478,0.43478260869565216
2079,0.28012788513054454,0.5508260404241494,24,16,8,0.6666666666666666,0.3333333333333333
2080,0.09932377054516611,0.6108612071511009,87,51,36,0.5862068965517241,0.41379310344827586
2081,-0.22709487807005646,0.5845559799076983,55,16,39,0.2909090909090909,0.7090909090909091
2082,0.7290478659172853,0.18047642904504282,3,3,0,1.0,0.0
2083,0.4173635066531244,0.501947768430523,21,17,4,0.8095238095238095,0.19047619047619047
2084,0.35705959021579475,0.5197202283150516,80,57,23,0.7125,0.2875
2085,-0.11861514663650541,0.5435536983875537,57,21,36,0.3684210526315789,0.631578947368421
2086,0.12317071486709279,0.5306672148474405,67,33,34,0.4925373134328358,0.5074626865671642
2087,0.04183344702635491,0.6803936547501894,7,5,2,0.7142857142857143,0.2857142857142857
2088,0.22241102720204836,0.5219831093825402,78,52,26,0.6666666666666666,0.3333333333333333
2089,-0.15457483815650144,0.5597128477695147,6,4,2,0.6666666666666666,0.3333333333333333
2090,0.2518917885919412,0.5199200213100382,15,10,5,0.6666666666666666,0.3333333333333333
2091,0.06254036877784998,0.5723408201315265,124,64,60,0.5161290322580645,0.4838709677419355
2092,-0.058539298945106566,0.6172210561355443,16,8,8,0.5,0.5
2093,0.31315595969896426,0.600809165470094,22,17,5,0.7727272727272727,0.22727272727272727
2094,-0.21443119810687172,0.5882744414687701,18,6,12,0.3333333333333333,0.6666666666666666
2095,0.006664722819219946,0.6836122711768913,11,7,4,0.6363636363636364,0.36363636363636365
2096,0.09766912280961318,0.5496917790054424,27,13,14,0.48148148148148145,0.5185185185185185
2097,0.0840053608020146,0.6941819841704776,3,1,2,0.3333333333333333,0.6666666666666666
2098,0.39514075149782,0.5174467665664205,40,33,7,0.825,0.175
2099,-0.005673503130674399,0.718911842649808,15,7,8,0.4666666666666667,0.5333333333333333
2100,-0.1984562068604506,0.7045158826523721,13,4,9,0.3076923076923077,0.6923076923076923
2101,0.17340892749146009,0.5736685679488075,39,22,17,0.5641025641025641,0.4358974358974359
2102,0.2837927143956567,0.5621133892286736,29,21,8,0.7241379310344828,0.27586206896551724
2103,0.09226418832937876,0.6696400111395485,15,8,7,0.5333333333333333,0.4666666666666667
2104,0.01173703337186262,0.6283008260347389,95,44,51,0.4631578947368421,0.5368421052631579
2105,0.22745764309850833,0.7537695128360868,12,8,4,0.6666666666666666,0.3333333333333333
2106,-0.20404968704455173,0.5860501508122441,26,8,18,0.3076923076923077,0.6923076923076923
2107,0.4994589659024258,0.5012690054459057,49,42,7,0.8571428571428571,0.14285714285714285
2108,-0.5465697251260281,0.28288117006449354,5,0,5,0.0,1.0
2109,0.800015300512314,,1,1,0,1.0,0.0
2110,-0.2467871877342099,0.6378117930451842,41,14,27,0.34146341463414637,0.6585365853658537
2111,0.24075173997698587,0.5844179082998116,128,84,44,0.65625,0.34375
2112,0.01030298843979837,0.4689529332573579,15,7,8,0.4666666666666667,0.5333333333333333
2113,-0.028580086732593685,0.6310404268842873,24,11,13,0.4583333333333333,0.5416666666666666
2114,-0.14932625262687607,0.6542528044267759,30,16,14,0.5333333333333333,0.4666666666666667
2115,0.052391514802972494,0.5785670401625637,24,12,12,0.5,0.5
2116,0.35239582668457714,0.5326021412920413,35,27,8,0.7714285714285715,0.22857142857142856
2117,0.001637076959013925,0.4953710053541458,8,3,5,0.375,0.625
2118,0.24675485119223595,0.5497438055555446,14,9,5,0.6428571428571429,0.35714285714285715
2119,0.11409414559602737,0.889716252605592,2,1,1,0.5,0.5
2120,-0.1383565992116928,0.5805894327629557,5,2,3,0.4,0.6
2121,-0.10818032016632734,0.6179586230951161,54,22,32,0.4074074074074074,0.5925925925925926
2122,0.04558716947212818,0.6213047088443227,8,4,4,0.5,0.5
2123,0.4706465117633343,0.4673900142321725,12,10,2,0.8333333333333334,0.16666666666666666
2124,0.16154836834623262,0.4498547554226803,26,15,11,0.5769230769230769,0.4230769230769231
2125,0.1899324471004686,0.5544767000208766,59,37,22,0.6271186440677966,0.3728813559322034
2126,0.24174122982903531,0.6251011870607096,19,11,8,0.5789473684210527,0.42105263157894735
2127,0.17214030820619444,0.5520352293000119,29,17,12,0.5862068965517241,0.41379310344827586
2128,0.20740461637350646,0.6218600832302531,22,13,9,0.5909090909090909,0.4090909090909091
2129,-0.05534698610956015,0.487475541693975,11,6,5,0.5454545454545454,0.45454545454545453
2130,0.02693437281996014,0.6827462021417978,10,6,4,0.6,0.4
2131,-0.20585144460201263,0.5400609163098224,5,2,3,0.4,0.6
2132,0.43515960399348,0.48446020172256304,104,81,23,0.7788461538461539,0.22115384615384615
2133,-0.29987190526855345,0.6302363448258305,34,11,23,0.3235294117647059,0.6764705882352942
2134,0.06230034229948241,0.5665999536499147,17,9,8,0.5294117647058824,0.47058823529411764
2135,0.008870089054107643,0.7062864095671688,5,3,2,0.6,0.4
2136,0.25356733091175554,0.4651704982611753,10,6,4,0.6,0.4
2137,-0.08244618773460385,0.6369935177867954,2,1,1,0.5,0.5
2138,-0.32390291281044487,0.5362774580253648,10,2,8,0.2,0.8
2139,0.4451384580073257,0.6762317152436479,6,5,1,0.8333333333333334,0.16666666666666666
2140,-0.15230076972188222,0.5598464079031205,18,7,11,0.3888888888888889,0.6111111111111112
2141,-0.16994208112979928,0.7242520792359755,6,3,3,0.5,0.5
2142,0.2892161679382508,0.5820137097049718,13,9,4,0.6923076923076923,0.3076923076923077
2143,-0.29545890958979726,0.5121456763066315,8,3,5,0.375,0.625
2144,-0.01584979845210909,0.6537497149979031,24,11,13,0.4583333333333333,0.5416666666666666
2145,0.12001051055267453,0.6253088969266989,9,5,4,0.5555555555555556,0.4444444444444444
2146,-0.28714858781960273,0.7674216851667487,9,3,6,0.3333333333333333,0.6666666666666666
2147,-0.16062422885614286,0.7189953609271421,17,7,10,0.4117647058823529,0.5882352941176471
2148,0.11919271647930145,0.3322421645933517,5,3,2,0.6,0.4
2149,0.5374074975649515,0.4610866840275049,3,3,0,1.0,0.0
2150,0.549668462947011,0.37035722817443495,4,4,0,1.0,0.0
2151,0.5361027717590332,,1,1,0,1.0,0.0
2152,0.5017865818614762,0.5553461566881805,6,5,1,0.8333333333333334,0.16666666666666666
2153,-0.09668247740377081,0.6552587997412134,11,6,5,0.5454545454545454,0.45454545454545453
2154,-0.14348473912104961,0.6813231417933145,8,4,4,0.5,0.5
2155,0.006276217289268943,0.7695758473676807,4,2,2,0.5,0.5
2156,-0.07700480573943683,0.6936354178819916,28,12,16,0.42857142857142855,0.5714285714285714
2157,0.13795602258788534,0.6311608746807962,83,49,34,0.5903614457831325,0.40963855421686746
2158,-0.07088801562786104,0.7164963232118542,20,8,12,0.4,0.6
2159,0.3096515439864662,0.5465346054836165,45,29,16,0.6444444444444445,0.35555555555555557
2160,-0.007931483062830853,0.4935504278149471,11,5,6,0.45454545454545453,0.5454545454545454
2161,-0.1735152438282967,0.6861900933565118,5,2,3,0.4,0.6
2162,-0.5448828265070915,0.016990732797181603,2,0,2,0.0,1.0
2163,0.16805469814468835,0.6071296621575317,17,10,7,0.5882352941176471,0.4117647058823529
2164,-0.019389480352401733,0.5044857810117195,4,2,2,0.5,0.5
2165,-0.08225258641565844,0.6950272899682275,6,3,3,0.5,0.5
2166,0.13331920405228934,0.5776529675790456,6,4,2,0.6666666666666666,0.3333333333333333
2167,-0.4968695829932888,0.37922604868132764,6,1,5,0.16666666666666666,0.8333333333333334
2168,-0.6233850866556168,0.36337869583734134,5,1,4,0.2,0.8
2169,0.729354728013277,0.08024909138589738,4,4,0,1.0,0.0
2170,0.07146912669254976,0.4879071002205852,22,12,10,0.5454545454545454,0.45454545454545453
2171,0.060475750161068764,0.6789695965687821,14,8,6,0.5714285714285714,0.42857142857142855
2173,0.1939983544871211,0.6826374182520196,10,6,4,0.6,0.4
2174,-0.12311585371692975,0.617447815861771,6,3,3,0.5,0.5
2176,-0.011154161610951063,0.6551390289954258,12,6,6,0.5,0.5
2177,-0.3175307661294937,0.16125023884713288,2,0,2,0.0,1.0
2178,0.32458066744729874,0.6314075770176051,20,13,7,0.65,0.35
2179,0.5591333359479904,,1,1,0,1.0,0.0
2180,-0.02408668292420248,0.7188576103275691,7,3,4,0.42857142857142855,0.5714285714285714
2181,-0.3556946257336272,0.5577355651599964,9,3,6,0.3333333333333333,0.6666666666666666
2182,0.35613992577418685,0.592257361076619,8,6,2,0.75,0.25
2183,-0.07069981087531363,0.6371849826871806,35,17,18,0.4857142857142857,0.5142857142857142
2184,0.8129055835306644,0.10815008295276547,2,2,0,1.0,0.0
2185,0.09888868741691112,0.6232686009227002,10,5,5,0.5,0.5
2186,0.1549879601225257,0.5092645118834371,4,2,2,0.5,0.5
2187,0.36533594576687345,0.5072192872822308,41,29,12,0.7073170731707317,0.2926829268292683
2188,0.12937257937429583,0.6435423078616013,17,9,8,0.5294117647058824,0.47058823529411764
2189,-0.05865564942359924,0.6706383354286778,2,1,1,0.5,0.5
2190,-0.2334423154592514,0.588069640966302,10,3,7,0.3,0.7
2191,-0.08564774226397279,0.6307485593592299,8,3,5,0.375,0.625
2192,-0.11121470650488682,0.6273372574291157,11,4,7,0.36363636363636365,0.6363636363636364
2193,0.0314726336962647,0.5554390173902217,9,4,5,0.4444444444444444,0.5555555555555556
2194,0.02935331066449487,0.5629873081723346,3,1,2,0.3333333333333333,0.6666666666666666
2195,-0.009133748710155487,0.9369693393275506,2,1,1,0.5,0.5
2196,-0.8769537247717382,,1,0,1,0.0,1.0
2197,0.2565546423196793,0.567960373259157,5,4,1,0.8,0.2
2198,0.35831642546691,0.5884557845887398,4,3,1,0.75,0.25
2199,0.3710595169104636,0.6114867948389271,8,5,3,0.625,0.375
2200,0.07214174040460163,0.6225766457835062,14,6,8,0.42857142857142855,0.5714285714285714
2201,0.23646034162353585,0.5564631833620751,27,16,11,0.5925925925925926,0.4074074074074074
2202,0.11818217911890573,0.6841314018528482,7,5,2,0.7142857142857143,0.2857142857142857
2203,0.8744883239269258,,1,1,0,1.0,0.0
2204,0.4373086988925934,0.3081187925261256,6,6,0,1.0,0.0
2206,-0.2663266585709957,0.6345123577128521,13,4,9,0.3076923076923077,0.6923076923076923
2207,-0.7158529236912727,0.10879436602088337,2,0,2,0.0,1.0
2208,-0.12944001331925395,0.6140308798003742,4,1,3,0.25,0.75
2209,0.008665654063224792,0.704364639370705,5,2,3,0.4,0.6
2210,0.39349111914634705,0.71470912834307,3,2,1,0.6666666666666666,0.3333333333333333
2211,0.5238480813801288,0.3992732785702329,5,5,0,1.0,0.0
2212,-0.05868443893268705,0.6879120581825702,8,4,4,0.5,0.5
2213,0.3471277402713895,0.6685573892033474,6,5,1,0.8333333333333334,0.16666666666666666
2214,0.32580679897218945,0.60217510267809,10,6,4,0.6,0.4
2215,0.29348148126155144,0.5155926101823929,4,3,1,0.75,0.25
2217,0.12936536169477872,0.7048436973158441,14,7,7,0.5,0.5
2218,0.11225466653704645,0.7248310250652673,5,3,2,0.6,0.4
2219,0.0027752241686634276,0.5567300017512382,23,10,13,0.43478260869565216,0.5652173913043478
2220,0.3488568188622594,0.6021333970455444,8,6,2,0.75,0.25
2221,0.2995206516236067,0.7960953236168401,5,3,2,0.6,0.4
2222,-0.21369759707401192,0.7447041470273644,6,3,3,0.5,0.5
2223,-0.022224089130759128,1.2295861288233076,2,1,1,0.5,0.5
2224,-0.8776222169399261,0.10121627836492743,2,0,2,0.0,1.0
2225,-0.3587732148858217,0.5617745401730067,13,5,8,0.38461538461538464,0.6153846153846154
2226,0.0781354606151581,0.336751685685327,3,2,1,0.6666666666666666,0.3333333333333333
2227,0.4822164196521043,0.6748949168813649,2,2,0,1.0,0.0
2228,-0.0054624272244317195,0.7094238009187779,7,3,4,0.42857142857142855,0.5714285714285714
2229,-0.12855027318000795,0.6405820124271496,5,2,3,0.4,0.6
2230,0.0962135238064961,0.5797284996239145,22,13,9,0.5909090909090909,0.4090909090909091
2231,-0.09862334839999674,0.8915349232958727,3,1,2,0.3333333333333333,0.6666666666666666
2232,0.1362304706126452,0.6504216203313843,4,3,1,0.75,0.25
2233,0.10637456604412622,0.6371159458632578,7,3,4,0.42857142857142855,0.5714285714285714
2234,0.1388653665781021,0.4653801468935029,4,2,2,0.5,0.5
2235,-0.26906587928533554,0.4226877493229043,8,1,7,0.125,0.875
2236,-0.27398726642131804,0.3751790606908598,5,2,3,0.4,0.6
2237,0.16810728609561923,0.5583006946463184,4,3,1,0.75,0.25
2238,-0.12518127914518118,0.5702687453278895,8,2,6,0.25,0.75
2239,-0.4949100613594055,0.20080379361028405,3,0,3,0.0,1.0
2240,-0.2512549813836813,0.9505949492016109,2,1,1,0.5,0.5
2241,-0.687994085252285,0.09931066060537919,3,0,3,0.0,1.0
2242,-0.06342774132887524,0.5216758052661614,3,1,2,0.3333333333333333,0.6666666666666666
2243,-0.3501116931438446,,1,0,1,0.0,1.0
2244,0.12158659762806368,0.6088509572185011,18,11,7,0.6111111111111112,0.3888888888888889
2245,0.6717976033687592,0.09370856540927285,2,2,0,1.0,0.0
2246,-0.8280813619494438,0.11498464224907237,2,0,2,0.0,1.0
2247,-0.22767464816570285,0.2873365822649295,2,0,2,0.0,1.0
2248,-0.09862451752026875,0.3970745169540483,12,5,7,0.4166666666666667,0.5833333333333334
2249,0.38884681742638355,0.677779827409547,4,3,1,0.75,0.25
2250,-0.11133084967732432,0.7586125504644168,5,2,3,0.4,0.6
2251,0.8107468634843829,,1,1,0,1.0,0.0
2252,0.8004455715417862,,1,1,0,1.0,0.0
2253,0.24646280705928808,0.11435917248045857,2,2,0,1.0,0.0
2254,0.16653722524642942,0.5748410775743263,2,1,1,0.5,0.5
2255,0.40404572151601326,0.641789973526324,4,3,1,0.75,0.25
2256,0.2244989251097044,0.7856316501228943,3,2,1,0.6666666666666666,0.3333333333333333
2257,-0.48170471191406256,,1,0,1,0.0,1.0
2258,-0.1362256407737732,0.2124110684602513,6,2,4,0.3333333333333333,0.6666666666666666
2259,-0.30552423497041065,0.6590710999825063,3,1,2,0.3333333333333333,0.6666666666666666
2260,-0.05063031613826752,0.07866230907827772,2,1,1,0.5,0.5
2262,0.07549676299095154,,1,1,0,1.0,0.0
2263,0.16616757214069366,0.4233289048685123,6,3,3,0.5,0.5
2264,-0.12422909438610079,0.6824685754004018,5,3,2,0.6,0.4
2265,-0.3553674581150214,0.5544665725409922,3,1,2,0.3333333333333333,0.6666666666666666
2266,0.22332258522510529,0.7560482706598526,2,1,1,0.5,0.5
2267,0.8079975545406343,,1,1,0,1.0,0.0
2269,-0.8024630770087242,,1,0,1,0.0,1.0
2270,-0.5328685641288757,,1,0,1,0.0,1.0
2271,-0.6336487274616956,0.3696972086667522,5,1,4,0.2,0.8
2272,-0.2373166110366583,0.5699390309608948,5,2,3,0.4,0.6
2273,-0.546036571264267,,1,0,1,0.0,1.0
2274,0.004992514848709162,,1,1,0,1.0,0.0
2275,0.9325679279863834,,1,1,0,1.0,0.0
2276,0.13439775755008063,0.6287495445023271,6,4,2,0.6666666666666666,0.3333333333333333
2277,-0.5328688472509384,,1,0,1,0.0,1.0
2278,0.20028382043043771,0.2828547728801992,3,3,0,1.0,0.0
2280,-0.0135826766490936,0.08643956166687176,2,1,1,0.5,0.5
2281,0.11004829158385597,0.7013704058598317,3,2,1,0.6666666666666666,0.3333333333333333
2282,-0.3564588725566864,,1,0,1,0.0,1.0
2283,-0.23963256180286405,0.3459529018873345,2,1,1,0.5,0.5
2284,-0.3305403411698838,0.6614686042395617,6,1,5,0.16666666666666666,0.8333333333333334
2285,0.07250057905912399,0.8269189656109062,2,1,1,0.5,0.5
2286,-0.33751916885375977,,1,0,1,0.0,1.0
2287,-0.6298198103904724,0.13710976735212385,2,0,2,0.0,1.0
2288,-0.7256941646337509,0.27976905239452565,2,0,2,0.0,1.0
2289,-0.11633187532424927,0.17157885091033384,2,1,1,0.5,0.5
2290,0.004992693662643433,,1,1,0,1.0,0.0
2291,0.9408829659223557,0.008518373309521647,2,2,0,1.0,0.0
